CALC	K AE L K
CHROME	K R OW M
CLOSE	K L OW S
CLOSE(2)	K L OW Z
CONTROL	K AH N T R OW L
EXCEL	IH K S EH L
EXPLORER	IH K S P L AO R ER
MUSIC	M Y UW Z IH K
OPEN	OW P AH N
POWER	P AW ER
THE	DH AH
THE(2)	DH IY
WORD	W ER D
   A   AH
   ABANDON	AH B AE N D AH N
   ABILITY	AH B IH L AH T IY
   ABLE	EY B AH L
   ABORTION	AH B AO R SH AH N
   ABOUT	AH B AW T
   ABOVE	AH B AH V
   ABROAD	AH B R AO D
   ABSENCE	AE B S AH N S
   ABSOLUTE	AE B S AH L UW T
   ABSOLUTELY	AE B S AH L UW T L IY
   ABSORB	AH B Z AO R B
   ABSTRACT	AE B S T R AE K T
   ABUSE	AH B Y UW Z
   ACADEMIC	AE K AH D EH M IH K
   ACCELERATE	IH K S EH L AH R EY T
   ACCENT	AE K S EH N T
   ACCEPT	AE K S EH P T
   ACCEPTABLE	AE K S EH P T AH B AH L
   ACCEPTANCE	AE K S EH P T AH N S
   ACCESS	AE K S EH S
   ACCESSIBLE	AE K S EH S AH B AH L
   ACCIDENT	AE K S AH D AH N T
   ACCOMMODATE	AH K AA M AH D EY T
   ACCOMPANY	AH K AH M P AH N IY
   ACCOMPLISH	AH K AA M P L IH SH
   ACCOMPLISHMENT	AH K AA M P L IH SH M AH N T
   ACCORDING	AH K AO R D IH NG
   ACCOUNT	AH K AW N T
   ACCOUNTABILITY	AH K AW N T AH B IH L AH T EH
   ACCOUNTING	AH K AW N T IH NG
   ACCURACY	AE K Y ER AH S IY
   ACCURATE	AE K Y ER AH T
   ACCURATELY	AE K Y ER AH T L IY
   ACCUSATION	AE K Y AH Z EY SH AH N
   ACCUSE	AH K Y UW Z
   ACHIEVE	AH CH IY V
   ACHIEVEMENT	AH CH IY V M AH N T
   ACID	AE S AH D
   ACKNOWLEDGE	AE K N AA L IH JH
   ACQUIRE	AH K W AY ER
   ACQUISITION	AE K W AH Z IH SH AH N
   ACROSS	AH K R AO S
   ACT	AE K T
   ACTION	AE K SH AH N
   ACTIVE	AE K T IH V
   ACTIVELY	AE K T IH V L IY
   ACTIVIST	AE K T IH V IH S T
   ACTIVITY	AE K T IH V AH T IY
   ACTOR	AE K T ER
   ACTRESS	AE K T R AH S
   ACTUAL	AE K CH AH W AH L
   ACTUALLY	AE K CH AH W AH L IY
   AD	AE D
   ADAPT	AH D AE P T
   ADD	AE D
   ADDED	AE D IH D
   ADDITION	AH D IH SH AH N
   ADDITIONAL	AH D IH SH AH N AH L
   ADDRESS	AH D R EH S
   ADEQUATE	AE D IH K W AH T
   ADJUST	AH JH AH S T
   ADJUSTMENT	AH JH AH S T M AH N T
   ADMINISTER	AH D M IH N AH S T ER
   ADMINISTRATION	AH D M IH N AH S T R EY SH AH N
   ADMINISTRATIVE	AH D M IH N AH S T R AH T IH V
   ADMINISTRATOR	AH D M IH N AH S T R AH T ER
   ADMIRE	AH D M AY ER
   ADMISSION	AH D M IH SH AH N
   ADMIT	AH D M IH T
   ADOLESCENT	AE D AH L EH S AH N T
   ADOPT	AH D AA P T
   ADOPTION	AH D AA P SH AH N
   ADULT	AH D AH L T
   ADVANCE	AH D V AE N S
   ADVANCED	AH D V AE N S T
   ADVANTAGE	AH D V AE N T IH JH
   ADVENTURE	AH D V EH N CH ER
   ADVERTISING	AE D V ER T AY Z IH NG
   ADVICE	AH D V AY S
   ADVISE	AH D V AY Z
   ADVISER	AH D V AY Z ER
   ADVOCATE	AE D V AH K AH T
   AESTHETIC	EH S TH EH T IH K
   AFFAIR	AH F EH R
   AFFECT	AH F EH K T
   AFFORD	AH F OW R D
   AFRAID	AH F R EY D
   AFRICAN	AE F R IH S AH N
   AFRICAN-AMERICAN	AE F R IH S AH N AH M EH R IH K AH N
   AFTER	AE F T ER
   AFTERNOON	AE F T ER N UW N
   AFTERWARD	AE F T ER W ER D
   AGAIN	AH G EH N
   AGAINST	AH G EH N S T
   AGE	EY JH
   AGENCY	EY JH AH N S IY
   AGENDA	AH JH EH N D AH
   AGENT	EY JH AH N T
   AGGRESSION	AH G R EH SH AH N
   AGGRESSIVE	AH G R EH S IH V
   AGO	AH G OW
   AGREE	AH G R IY
   AGREEMENT	AH G R IY M AH N T
   AGRICULTURAL	AE G R IH K AH L CH AH R AH L
   AGRICULTURE	AE G R IH K AH L CH ER
   AH	AA
   AHEAD	AH HH EH D
   AID	EY D
   AIDE	EY D
   AIDS	EY D Z
   AIM	EY M
   AIR	EH R
   AIRCRAFT	AH IH R K R AE F T
   AIRLINE	AH IH R L AY N
   AIRPLANE	AH IH R P L EY N
   AIRPORT	AH IH R P OW R T
   AISLE	AY L
   ALARM	AH L AA R M
   ALBUM	AE L B AH M
   ALCOHOL	AE L K AH HH AO L
   ALIEN	EY L IY AH N
   ALIKE	AH L AY K
   ALIVE	AH L IH V
   ALL	AO L
   ALLEGATION	AE L IH G EY SH AH N
   ALLEGED	AH L EH JH D
   ALLEGEDLY	AH L EH JH AH D L IY
   ALLEY	AE L IY
   ALLIANCE	AH L AY AH N S
   ALLOW	AH L AW
   ALLY	AH L AY
   ALMOST	AO L M OW S T
   ALONE	AH L OW N
   ALONG	AH L AO NG
   ALONGSIDE	AH L AO NG S AY D
   ALREADY	AO L R EH D IY
   ALSO	AO L S OW
   ALTER	AO L T ER
   ALTERNATIVE	AO L T ER N AH T IH V
   ALTHOUGH	AO L DH OW
   ALTOGETHER	AO L T AH G EH DH ER
   ALUMINUM	AH L UW M AH N AH M
   ALWAYS	AO L W EY Z
   AM	AE M
   AMAZING	AH M EY Z IH NG
   AMBASSADOR	AE M B AE S AH D ER
   AMBITION	AE M B IH SH AH N
   AMBITIOUS	AE M B IH SH AH S
   AMENDMENT	AH M EH N D M AH N T
   AMERICAN	AH M EH R AH K AH N
   AMID	AH M IH D
   AMONG	AH M AH NG
   AMOUNT	AH M AW N T
   ANALYSIS	AH N AE L AH S AH S
   ANALYST	AE N AH L AH S T
   ANALYZE	AE N AH L AY Z
   ANCESTOR	AE N S EH S T ER
   ANCIENT	EY N SH AH N T
   AND	AE N D
   AND/OR	AE N D AO R
   ANGEL	EY N JH AH L
   ANGER	AE NG G ER
   ANGLE	AE NG G AH L
   ANGRY	AE NG G R IY
   ANIMAL	AE N AH M AH L
   ANKLE	AE NG K AH L
   ANNIVERSARY	AE N AH V ER S AH R IY
   ANNOUNCE	AH N AW N S
   ANNOUNCEMENT	AH N AW N S M AH N T
   ANNUAL	AE N Y AH W AH L
   ANNUALLY	AE N Y AH W AH L IY
   ANONYMOUS	AH N AA N AH M AH S
   ANOTHER	AH N AH DH ER
   ANSWER	AE N S ER
   ANTICIPATE	AE N T IH S AH P AH T
   ANXIETY	AE NG Z AY AH T IY
   ANXIOUS	AE NG K SH AH S
   ANY	EH N IY
   ANYBODY	EH N IY B AA D IY
   ANYMORE	EH N IY M OW R
   ANYONE	EH N IY W AH N
   ANYTHING	EH N IY TH IH NG
   ANYWAY	EH N IY W EY
   ANYWHERE	EH N IY W EH ER
   APART	AH P AA R T
   APARTMENT	AH P AA R T M AH N T
   APOLOGIZE	AH P AA L AH JH AY Z
   APOLOGY	AH P AA L AH JH IY
   APPARENT	AH P AE R AH N T
   APPARENTLY	AH P AE R AH N T L IY
   APPEAL	AH P IY L
   APPEAR	AH P IH ER
   APPEARANCE	AH P IH ER AH N S
   APPLE	AE P AH L
   APPLICATION	AE P L IH K EY SH AH N
   APPLY	AH P L AY
   APPOINT	AH P OY N T
   APPOINTMENT	AH P OY N T M AH N T
   APPRECIATE	AH P R IY SH IY EY T
   APPRECIATION	AH P R IY SH IY EY SH AH N
   APPROACH	AH P R OW CH
   APPROPRIATE	AH P R OW P R IY AH T
   APPROVAL	AH P R UW V AH L
   APPROVE	AH P R UW V
   APPROXIMATELY	AH P R AA K S AH M AH T L IY
   ARAB	AE R AH B
   ARCHITECT	AA R K AH T EH K T
   ARCHITECTURE	AA R K AH T EH K CH ER
   AREA	AE R IY AH
   ARENA	AH R IY N AH
   ARGUE	AA R G Y UW
   ARGUMENT	AA R G Y AH M AH N T
   ARISE	AH R AY Z
   ARM	AA R M
   ARMED	AA R M D
   ARMY	AA R M IY
   AROUND	AH R AW N D
   ARRANGE	AH R EY N JH
   ARRANGEMENT	AH R EY N JH M AH N T
   ARRAY	AH R EY
   ARREST	AH R EH S T
   ARRIVAL	AH R AY V AH L
   ARRIVE	AH R AY V
   ARROW	AE R OW
   ART	AA R T
   ARTICLE	AA R T IH K AH L
   ARTICULATE	AA R T IH K Y AH L AH T
   ARTIFACT	AA R T AH F AE K T
   ARTIFICIAL	AA R T AH F IH SH AH L
   ARTIST	AA R T IH S T
   ARTISTIC	AA R T IH S T IH K
   AS	AE Z
   ASH	AE SH
   ASIAN	EY Z IY AH N
   ASIDE	AH S AY D
   ASK	AE S K
   ASLEEP	AH S L IY P
   ASPECT	AE S P EH K T
   ASS	AE S
   ASSAULT	AH S AO L T
   ASSEMBLE	AH S EH M B AH L
   ASSEMBLY	AH S EH M B L IY
   ASSERT	AH S ER T
   ASSESS	AH S EH S
   ASSESSMENT	AH S EH S M AH N T
   ASSET	AE S EH T
   ASSIGN	AH S AY N
   ASSIGNMENT	AH S AY N M AH N T
   ASSIST	AH S IH S T
   ASSISTANCE	AH S IH S T AH N S
   ASSISTANT	AH S IH S T AH N T
   ASSOCIATE	AH S OW S IY AH T
   ASSOCIATED	AH S OW S IY EY T IH D
   ASSOCIATION	AH S OW S IY EY SH AH N
   ASSUME	AH S UW M
   ASSUMPTION	AH S AH M P SH AH N
   ASSURE	AH SH UW R
   ASTRONOMER	AH S T R AA N AH M ER
   AT	AE T
   ATHLETE	AE TH L IY T
   ATHLETIC	AE TH L EH T IH K
   ATMOSPHERE	AE T M AH S F IH ER
   ATOP	AH T AA P
   ATTACH	AH T AE CH
   ATTACK	AH T AE K
   ATTEMPT	AH T EH M P T
   ATTEND	AH T EH N D
   ATTENDANCE	AH T EH N D AH N S
   ATTENTION	AH T EH N CH AH N
   ATTITUDE	AE T AH T UW D
   ATTORNEY	AH T ER N IY
   ATTRACT	AH T R AE K T
   ATTRACTION	AH T R AE K SH AH N
   ATTRACTIVE	AH T R AE K T IH V
   ATTRIBUTE	AE T R AH B Y UW T
   AUCTION	AO K SH AH N
   AUDIENCE	AO D IY AH N S
   AUNT	AE N T
   AUTHOR	AO TH ER
   AUTHORITY	AH TH AO R AH T IY
   AUTHORIZE	AO TH ER AY Z
   AUTO	AO T OW
   AUTOMATIC	AO T AH M AE T IH K
   AUTOMATICALLY	AO T AH M AE T IH K AH L IY
   AUTOMOBILE	AO T AH M OW B IY L
   AUTONOMY	AO T AA N AH M IY
   AVAILABILITY	AH V EY L AH B IH L AH T EH
   AVAILABLE	AH V EY L AH B AH L
   AVERAGE	AE V R IH JH
   AVOID	AH V OY D
   AWAIT	AH W EY T
   AWAKE	AH W EY K
   AWARD	AH W AO R D
   AWARE	AH W EH R
   AWARENESS	AH W EH R N AH S
   AWAY	AH W EY
   AWFUL	AO F AH L
   BABY	B EY B IY
   BACK	B AE K
   BACKGROUND	B AE K G R AW N D
   BACKYARD	B AE K Y AA R D
   BACTERIA	B AE K T IH R IY AH
   BAD	B AE D
   BADLY	B AE D L IY
   BAG	B AE G
   BAKE	B EY K
   BALANCE	B AE L AH N S
   BALANCED	B AE L AH N S T
   BALL	B AO L
   BALLOON	B AH L UW N
   BALLOT	B AE L AH T
   BAN	B AE N
   BANANA	B AH N AE N AH
   BAND	B AE N D
   BANK	B AE NG K
   BANKER	B AE NG K ER
   BANKING	B AE NG K IH NG
   BANKRUPTCY	B AE NG K R AH P S IY
   BAR	B AA R
   BARE	B EH R
   BARELY	B AE R L IY
   BARN	B AA R N
   BARREL	B AE R AH L
   BARRIER	B AE R IY ER
   BASE	B EY S
   BASEBALL	B EY S B AO L
   BASEMENT	B EY S M AH N T
   BASIC	B EY S IH K
   BASICALLY	B EY S IH K AH L IY
   BASIS	B EY S AH S
   BASKET	B AE S K AH T
   BASKETBALL	B AE S K AH T B AO L
   BAT	B AE T
   BATH	B AE TH
   BATHROOM	B AE TH R UW M
   BATTERY	B AE T AH R IY
   BATTLE	B AE T AH L
   BAY	B EY
   BE	B IY
   BEACH	B IY CH
   BEAM	B IY M
   BEAN	B IY N
   BEAR	B AE ER
   BEARD	B IH ER D
   BEAST	B IY S T
   BEAT	B IY T
   BEAUTIFUL	B Y UW T IY F AH L
   BEAUTY	B Y UW T IY
   BECAUSE	B IH K AO Z
   BECOME	B IH K AH M
   BED	B EH D
   BEDROOM	B EH D R UW M
   BEE	B IY
   BEEF	B IY F
   BEER	B IH ER
   BEFORE	B IH F OW R
   BEG	B EH G
   BEGIN	B IH G IH N
   BEGINNING	B IH G IH N IH NG
   BEHALF	B IH HH AE F
   BEHAVE	B IH HH EY V
   BEHAVIOR	B IH HH EY V Y ER
   BEHAVIORAL	B IH HH EY V Y ER AH L
   BEHIND	B IH HH AY N D
   BEING	B IY IH NG
   BELIEF	B AH L IY F
   BELIEVE	B AH L IY V
   BELL	B EH L
   BELLY	B EH L IY
   BELONG	B IH L AO NG
   BELOW	B IH L OW
   BELT	B EH L T
   BENCH	B EH N CH
   BEND	B EH N D
   BENEATH	B IH N IY TH
   BENEFIT	B EH N AH F IH T
   BESIDE	B IH S AY D
   BESIDES	B IH S AY D Z
   BEST	B EH S T
   BET	B EH T
   BETTER	B EH T ER
   BETWEEN	B IH T W IY N
   BEYOND	B IY AA N D
   BIAS	B AY AH S
   BIBLE	B AY B AH L
   BICYCLE	B AY S IH K AH L
   BID	B IH D
   BIG	B IH G
   BIKE	B AY K IY
   BILL	B IH L
   BILLION	B IH L Y AH N
   BIND	B AY N D
   BIOGRAPHY	B AY AA G R AH F IY
   BIOLOGICAL	B AY AH L AA JH IH K AH L
   BIOLOGY	B AY AA L AH JH IY
   BIRD	B ER D
   BIRTH	B ER TH
   BIRTHDAY	B ER TH D EY
   BISHOP	B IH SH AH P
   BIT	B IH T
   BITE	B AY T
   BITTER	B IH T ER
   BLACK	B L AE K
   BLADE	B L EY D
   BLAME	B L EY M
   BLANK	B L AE NG K
   BLANKET	B L AE NG K AH T
   BLAST	B L AE S T
   BLEND	B L EH N D
   BLESS	B L EH S
   BLESSING	B L EH S IH NG
   BLIND	B L AY N D
   BLINK	B L IH NG K
   BLOCK	B L AA K
   BLOND	B L AA N D
   BLOOD	B L AH D
   BLOODY	B L AH D IY
   BLOW	B L OW
   BLUE	B L UW
   BOARD	B OW R D
   BOAST	B OW S T
   BOAT	B OW T
   BODY	B AA D IY
   BOIL	B OY L
   BOLD	B OW L D
   BOLT	B OW L T
   BOMB	B AA M
   BOMBING	B AA M IH NG
   BOND	B AA N D
   BONE	B OW N
   BONUS	B OW N AH S
   BOOK	B UH K
   BOOM	B UW M
   BOOST	B UW S T
   BOOT	B UW T
   BOOTH	B UW TH
   BORDER	B AO R D ER
   BORING	B AO R IH NG
   BORN	B AO R N
   BORROW	B AA R OW
   BOSS	B AO S
   BOTH	B OW TH
   BOTHER	B AA DH ER
   BOTTLE	B AA T AH L
   BOTTOM	B AA T AH M
   BOUNCE	B AW N S
   BOUNDARY	B AW N D R IY
   BOW	B AW
   BOWL	B OW L
   BOX	B AA K S
   BOY	B OY
   BOYFRIEND	B OY F R EH N D
   BRAIN	B R EY N
   BRAKE	B R EY K
   BRANCH	B R AE N CH
   BRAND	B R AE N D
   BRAVE	B R EY V
   BREAD	B R EH D
   BREAK	B R EY K
   BREAKFAST	B R EH K F AH S T
   BREAST	B R EH S T
   BREATH	B R EH TH
   BREATHE	B R IY DH
   BREATHING	B R IY DH IH NG
   BREEZE	B R IY Z
   BRICK	B R IH K
   BRIDE	B R AY D
   BRIDGE	B R IH JH
   BRIEF	B R IY F
   BRIEFLY	B R IY F L IY
   BRIGHT	B R AY T
   BRILLIANT	B R IH L Y AH N T
   BRING	B R IH NG
   BRITISH	B R IH T IH SH
   BROAD	B R AO D
   BROADCAST	B R AO D K AE S T
   BROKEN	B R OW K AH N
   BROKER	B R OW K ER
   BRONZE	B R AA N Z
   BROTHER	B R AH DH ER
   BROWN	B R AW N
   BRUSH	B R AH SH
   BRUTAL	B R UW T AH L
   BUBBLE	B AH B AH L
   BUCK	B AH K
   BUCKET	B AH K AH T
   BUDDY	B AH D IY
   BUDGET	B AH JH AH T
   BUG	B AH G
   BUILD	B IH L D
   BUILDER	B IH L D ER
   BUILDING	B IH L D IH NG
   BULB	B AH L B
   BULK	B AH L K
   BULL	B UH L
   BULLET	B UH L AH T
   BUNCH	B AH N CH
   BURDEN	B ER D AH N
   BUREAU	B Y UH R OW
   BURN	B ER N
   BURNING	B ER N IH NG
   BURST	B ER S T
   BURY	B EH R IY
   BUS	B AH S
   BUSH	B UH SH
   BUSINESS	B IH Z N AH S
   BUSINESSMAN	B IH Z N AH S M AE N
   BUSY	B IH Z IY
   BUT	B AH T
   BUTT	B AH T
   BUTTER	B AH T ER
   BUTTERFLY	B AH T ER F L AY
   BUTTON	B AH T AH N
   BUY	B AY
   BUYER	B AY ER
   BY	B AY
   CAB	K AE B
   CABIN	K AE B AH N
   CABINET	K AE B N AH T
   CABLE	K EY B AH L
   CAGE	K EY JH
   CAKE	K EY K
   CALCULATE	K AE L K Y AH L AH T
   CALCULATION	K AE L K Y AH L EY SH AH N
   CALENDAR	K AE L AH N D ER
   CALL	K AO L
   CALM	K AA M
   CAMERA	K AE M R AH
   CAMP	K AE M P
   CAMPAIGN	K AE M P EY N
   CAMPUS	K AE M P AH S
   CAN	K AE N
   CANADIAN	K AH N EY D IY AH N
   CANCEL	K AE N S AH L
   CANCER	K AE N S ER
   CANDIDATE	K AE N D AH D AH T
   CANDLE	K AE N D AH L
   CANDY	K AE N D IY
   CANVAS	K AE N V AH S
   CAP	K AE P
   CAPABILITY	K EY P AH B IH L AH T IY
   CAPABLE	K EY P AH B AH L
   CAPACITY	K AH P AE S AH T IY
   CAPITAL	K AE P AH T AH L
   CAPTAIN	K AE P T AH N
   CAPTURE	K AE P CH ER
   CAR	K AA R
   CARBOHYDRATE	K AA R B OW HH AY D R EY T
   CARBON	K AA R B AH N
   CARD	K AA R D
   CARE	K EH R
   CAREER	K AH R IH ER
   CAREFUL	K EH R F AH L
   CAREFULLY	K EH R F AH L IY
   CARGO	K AA R G OW
   CARPET	K AA R P AH T
   CARRIER	K AE R IY ER
   CARROT	K AE R AH T
   CARRY	K AE R IY
   CART	K AA R T
   CARTOON	K AA R T UW N
   CARVE	K AA R V
   CASE	K EY S
   CASH	K AE SH
   CASINO	K AH S IY N OW
   CAST	K AE S T
   CASUAL	K AE ZH AH W AH L
   CASUALTY	K AE ZH AH W AH L T IY
   CAT	K AE T
   CATALOG	K AE T AH L AO G
   CATCH	K AE CH
   CATEGORY	K AE T IH G AO R IY
   CATHOLIC	K AE TH L IH K
   CATTLE	K AE T AH L
   CAUSE	K AO Z
   CAVE	K EY V
   CEASE	S IY S
   CEILING	S EH L IH NG
   CELEBRATE	S EH L AH B R AH T
   CELEBRATION	S EH L AH B R EY SH AH N
   CELEBRITY	S AH L EH B R AH T IY
   CELL	S EH L
   CEMETERY	S EH M AH T EH R IY
   CENTER	S EH N T ER
   CENTRAL	S EH N T R AH L
   CENTURY	S EH N CH AH R IY
   CEO	S IY OW
   CEREMONY	S EH R AH M OW N IY
   CERTAIN	S ER T AH N
   CERTAINLY	S ER T AH N L IY
   CHAIN	CH EY N
   CHAIR	CH EH ER
   CHAIRMAN	CH EH ER M AE N
   CHALLENGE	CH AE L AH N JH
   CHAMBER	CH EY M B ER
   CHAMPION	CH AE M P IY AH N
   CHAMPIONSHIP	CH AE M P IY AH N SH IH P
   CHANCE	CH AE N S
   CHANGE	CH EY N JH
   CHANGING	CH EY N JH IH NG
   CHANNEL	CH AE N AH L
   CHAOS	K EY AA S
   CHAPTER	CH AE P T ER
   CHARACTER	K AE R IH K T ER
   CHARACTERISTIC	K AE R IH K T AH R IH S T IH K
   CHARACTERIZE	K AE R IH K T ER AY Z
   CHARGE	CH AA R JH
   CHARITY	CH AE R AH T IY
   CHARM	CH AA R M
   CHART	CH AA R T
   CHARTER	CH AA R T ER
   CHASE	CH EY S
   CHEAP	CH IY P
   CHEAT	CH IY T
   CHECK	CH EH K
   CHEEK	CH IY K
   CHEER	CH IH ER
   CHEESE	CH IY Z
   CHEF	SH EH F
   CHEMICAL	K EH M IH K AH L
   CHEMISTRY	K EH M AH S T R IY
   CHEST	CH EH S T
   CHEW	CH UW
   CHICKEN	CH IH K AH N
   CHIEF	CH IY F
   CHILD	CH AY L D
   CHILDHOOD	CH AY L D HH UH D
   CHILL	CH IH L
   CHIN	CH IH N
   CHINESE	CH AY N IY Z
   CHIP	CH IH P
   CHOCOLATE	CH AA K L AH T
   CHOICE	CH OY S
   CHOLESTEROL	K AH L EH S T AH R AO L
   CHOOSE	CH UW Z
   CHOP	CH AA P
   CHRISTIAN	K R IH S CH AH N
   CHRISTIANITY	K R IH S CH AH N AH T IY
   CHRISTMAS	K R IH S T M AH Z
   CHRONIC	K R AA N IH K
   CHUNK	CH AH NG K
   CHURCH	CH ER CH
   CIGARETTE	S IH G AH R EH T
   CIRCLE	S ER K AH L
   CIRCUIT	S ER K AH T
   CIRCUMSTANCE	S ER K AH M S T AE N S
   CITE	S AY T
   CITIZEN	S IH T AH Z AH N
   CITIZENSHIP	S IH T AH Z AH N SH IH P
   CITY	S IH T IY
   CIVIC	S IH V IH K
   CIVIL	S IH V AH L
   CIVILIAN	S AH V IH L Y AH N
   CIVILIZATION	S IH V AH L AH Z EY SH AH N
   CLAIM	K L EY M
   CLASS	K L AE S
   CLASSIC	K L AE S IH K
   CLASSICAL	K L AE S IH K AH L
   CLASSIFY	K L AE S AH F AY
   CLASSROOM	K L AE S R UW M
   CLAY	K L EY
   CLEAN	K L IY N
   CLEAR	K L IH ER
   CLEARLY	K L IH ER L IY
   CLERK	K L ER K
   CLICK	K L IH K
   CLIENT	K L AY AH N T
   CLIFF	K L IH F
   CLIMATE	K L AY M AH T
   CLIMB	K L AY M
   CLING	K L IH NG
   CLINIC	K L IH N IH K
   CLINICAL	K L IH N IH K AH L
   CLIP	K L IH P
   CLOCK	K L AA K
   CLOSE	K L OW Z
   CLOSED	K L OW Z D
   CLOSELY	K L OW Z L IY
   CLOSER	K L OW Z ER
   CLOSEST	K L OW Z AH S T
   CLOSET	K L AA Z AH T
   CLOTH	K L AO TH
   CLOTHES	K L OW DH Z
   CLOTHING	K L OW DH IH NG
   CLOUD	K L AW D
   CLUB	K L AH B
   CLUE	K L UW
   CLUSTER	K L AH S T ER
   COACH	K OW CH
   COAL	K OW L
   COALITION	K OW AH L IH SH AH N
   COAST	K OW S T
   COASTAL	K OW S T AH L
   COAT	K OW T
   COCAINE	K OW K EY N
   CODE	K OW D
   COFFEE	K AO F IY
   COGNITIVE	K AA G N AH T IH V
   COIN	K OY N
   COLD	K OW L D
   COLLABORATION	K AH L AE B AH R EY SH AH N
   COLLAPSE	K AH L AE P S
   COLLAR	K AA L ER
   COLLEAGUE	K AA L IY G
   COLLECT	K AA L IH K T
   COLLECTION	K AA L IH K SH AH N
   COLLECTIVE	K AA L IH K T IH V
   COLLECTOR	K AA L IH K T ER
   COLLEGE	K AA L IH JH
   COLONIAL	K AH L OW N IY AH L
   COLONY	K AA L AH N IY
   COLOR	K AH L ER
   COLORFUL	K AH L ER F AH L
   COLUMN	K AA L AH M
   COLUMNIST	K AA L AH M IH S T
   COMBAT	K AH M B AE T
   COMBINATION	K AA M B AH N EY SH AH N
   COMBINE	K AH M B AY N
   COMBINED	K AH M B AY N D
   COME	K AH M
   COMEDY	K AA M AH D IY
   COMFORT	K AH M F ER T
   COMFORTABLE	K AH M F ER T AH B AH L
   COMING	K AH M IH NG
   COMMAND	K AH M AE N D
   COMMANDER	K AH M AE N D ER
   COMMENT	K AA M EH N T
   COMMERCIAL	K AH M ER SH AH L
   COMMISSION	K AH M IH SH AH N
   COMMISSIONER	K AH M IH SH AH N ER
   COMMIT	K AH M IH T
   COMMITMENT	K AH M IH T M AH N T
   COMMITTEE	K AH M IH T IY
   COMMODITY	K AH M AA D AH T IY
   COMMON	K AA M AH N
   COMMONLY	K AA M AH N L IY
   COMMUNICATE	K AH M Y UW N AH K AH T
   COMMUNICATION	K AH M Y UW N AH K EY SH AH N
   COMMUNITY	K AH M Y UW N AH T IY
   COMPANION	K AH M P AE N Y AH N
   COMPANY	K AH M P AH N IY
   COMPARABLE	K AA M P AH R AH B AH L
   COMPARE	K AH M P EH R
   COMPARISON	K AH M P AE R AH S AH N
   COMPEL	K AH M P EH L
   COMPELLING	K AH M P EH L IH NG
   COMPENSATION	K AH M P EH N S EY SH AH N
   COMPETE	K AH M P IY T
   COMPETITION	K AA M P AH T IH SH AH N
   COMPETITIVE	K AH M P EH T AH T IH V
   COMPETITOR	K AH M P EH T AH T ER
   COMPLAIN	K AH M P L EY N
   COMPLAINT	K AH M P L EY N T
   COMPLETE	K AH M P L IY T
   COMPLETELY	K AH M P L IY T L IY
   COMPLEX	K AH M P L EH K S
   COMPLEXITY	K AH M P L EH K S AH T IY
   COMPLIANCE	K AH M P L AY AH N S
   COMPLICATED	K AA M P L AH K EY T IH D
   COMPLY	K AH M P L AY
   COMPONENT	K AH M P OW N AH N T
   COMPOSE	K AH M P OW Z
   COMPOSITION	K AA M P AH Z IH SH AH N
   COMPOUND	K AH M P AW N D
   COMPREHENSIVE	K AA M P R IH HH EH N S IH V
   COMPRISE	K AH M P R AY Z
   COMPROMISE	K AA M P R AH M AY Z
   COMPUTER	K AH M P Y UW T ER
   CONCEDE	K AH N S IY D
   CONCEIVE	K AH N S IY V
   CONCENTRATE	K AA N S AH N T R EY T
   CONCENTRATION	K AA N S AH N T R EY SH AH N
   CONCEPT	K AA N S EH P T
   CONCEPTION	K AA N S EH P SH AH N
   CONCERN	K AH N S ER N
   CONCERNED	K AH N S ER N D
   CONCERNING	K AH N S ER N IH NG
   CONCERT	K AH N S ER T
   CONCLUDE	K AH N K L UW D
   CONCLUSION	K AH N K L UW ZH AH N
   CONCRETE	K AA N K R IY T
   CONDEMN	K AH N D EH M
   CONDITION	K AH N D IH SH AH N
   CONDUCT	K AA N D AH K T
   CONFERENCE	K AA N F AH R AH N S
   CONFESS	K AH N F EH S
   CONFESSION	K AH N F EH SH AH N
   CONFIDENCE	K AA N F AH D AH N S
   CONFIDENT	K AA N F AH D AH N T
   CONFIRM	K AH N F ER M
   CONFLICT	K AA N F L IH K T
   CONFRONT	K AH N F R AH N T
   CONFRONTATION	K AA N F R AH N T EY SH AH N
   CONFUSE	K AH N F Y UW Z
   CONFUSION	K AH N F Y UW ZH AH N
   CONGRESS	K AA NG G R AH S
   CONGRESSIONAL	K AH N G R EH SH AH N AH L
   CONNECT	K AH N EH K T
   CONNECTION	K AH N EH K SH AH N
   CONSCIENCE	K AA N CH AH N S
   CONSCIOUS	K AA N SH AH S
   CONSCIOUSNESS	K AA N SH AH S N AH S
   CONSECUTIVE	K AH N S EH K Y AH T IH V
   CONSENSUS	K AH N S EH N S AH S
   CONSENT	K AH N S EH N T
   CONSEQUENCE	K AA N S AH K W AH N S
   CONSEQUENTLY	K AA N S AH K W AH N T L IY
   CONSERVATION	K AH N S ER V EY SH AH N
   CONSERVATIVE	K AH N S ER V AH T IH V
   CONSIDER	K AH N S IH D ER
   CONSIDERABLE	K AH N S IH D ER AH B AH L
   CONSIDERABLY	K AH N S IH D ER AH B L IY
   CONSIDERATION	K AH N S IH D ER EY SH AH N
   CONSIST	K AH N S IH S T
   CONSISTENT	K AH N S IH S T AH N T
   CONSISTENTLY	K AH N S IH S T AH N T L IY
   CONSPIRACY	K AH N S P IH R AH S IY
   CONSTANT	K AA N S T AH N T
   CONSTANTLY	K AA N S T AH N T L IY
   CONSTITUTE	K AA N S T AH T UW T
   CONSTITUTION	K AA N S T AH T UW SH AH N
   CONSTITUTIONAL	K AA N S T AH T UW SH AH N AH L
   CONSTRAINT	K AH N S T R EY N T
   CONSTRUCT	K AH N S T R AH K T
   CONSTRUCTION	K AH N S T R AH K SH AH N
   CONSULT	K AH N S AH L T
   CONSULTANT	K AH N S AH L T AH N T
   CONSUME	K AH N S UW M
   CONSUMER	K AH N S UW M ER
   CONSUMPTION	K AH N S AH M P SH AH N
   CONTACT	K AA N T AE K T
   CONTAIN	K AH N T EY N
   CONTAINER	K AH N T EY N ER
   CONTEMPLATE	K AA N T AH M P L EY T
   CONTEMPORARY	K AH N T EH M P AH R EH R IY
   CONTEND	K AH N T EH N D
   CONTENT	K AH N T EH N T
   CONTEST	K AH N T EH S T
   CONTEXT	K AA N T EH K S T
   CONTINENT	K AA N T AH N AH N T
   CONTINUE	K AH N T IH N Y UW
   CONTINUED	K AH N T IH N Y UW D
   CONTINUING	K AH N T IH N Y UW IH NG
   CONTINUOUS	K AH N T IH N Y UW AH S
   CONTRACT	K AA N T R AE K T
   CONTRACTOR	K AA N T R AE K T ER
   CONTRAST	K AA N T R AE S T
   CONTRIBUTE	K AH N T R IH B Y UW T
   CONTRIBUTION	K AA N T R AH B Y UW SH AH N
   CONTRIBUTOR	K AH N T R IH B Y UW T ER
   CONTROL	K AH N T R OW L
   CONTROVERSIAL	K AA N T R AH V ER SH AH L
   CONTROVERSY	K AA N T R AH V ER S IY
   CONVENIENCE	K AH N V IY N Y AH N S
   CONVENTION	K AA N V AH N CH AH N
   CONVENTIONAL	K AA N V AH N CH AH N AH L
   CONVERSATION	K AA N V ER S EY SH AH N
   CONVERSION	K AH N V ER ZH AH N
   CONVERT	K AH N V ER T
   CONVEY	K AH N V EY
   CONVICT	K AA N V IH K T
   CONVICTION	K AA N V IH K SH AH N
   CONVINCE	K AH N V IH N S
   CONVINCED	K AH N V IH N S T
   COOK	K UH K
   COOKIE	K UH K IY
   COOKING	K UH K IH NG
   COOL	K UW L
   COOPERATE	K OW AA P ER AH T
   COOPERATION	K OW AA P ER EY SH AH N
   COOPERATIVE	K OW AA P ER AH T IH V
   COORDINATE	K OW AO R D AH N AH T
   COORDINATOR	K OW AO R D AH N AH T ER
   COP	K AA P
   COPE	K OW P
   COPY	K AA P IY
   CORD	K AO R D
   CORE	K OW R
   CORN	K AO R N
   CORNER	K AO R N ER
   CORPORATE	K AO R P ER AH T
   CORPORATION	K AO R P ER EY SH AH N
   CORRECT	K AH R EH K T
   CORRECTLY	K AH R EH K T L IY
   CORRELATION	K AO R AH L EY SH AH N
   CORRESPONDENT	K AO R AH S P AA N D AH N T
   CORRIDOR	K AO R AH D ER
   CORRUPTION	K AH R AH P SH AH N
   COST	K AO S T
   COSTLY	K AO S T L IY
   COSTUME	K AA S T UW M
   COTTAGE	K AA T IH JH
   COTTON	K AA T AH N
   COUCH	K AW CH
   COULD	K UH D
   COUNCIL	K AW N S AH L
   COUNSEL	K AW N S AH L
   COUNSELING	K AW N S AH L IH NG
   COUNSELOR	K AW N S AH L ER
   COUNT	K AW N T
   COUNTER	K AW N T ER
   COUNTERPART	K AW N T ER P AA R T
   COUNTRY	K AH N T R IY
   COUNTY	K AW N T IY
   COUP	K UW
   COUPLE	K AH P AH L
   COURAGE	K ER IH JH
   COURSE	K OW R S
   COURT	K OW R T
   COURTROOM	K OW R T R UW M
   COUSIN	K AH Z AH N
   COVER	K AH V ER
   COVERAGE	K OW V EH R IH JH
   COW	K AW
   CRACK	K R AE K
   CRAFT	K R AE F T
   CRASH	K R AE SH
   CRAWL	K R AO L
   CRAZY	K R EY Z IY
   CREAM	K R IY M
   CREATE	K R IY EY T
   CREATION	K R IY EY SH AH N
   CREATIVE	K R IY EY T IH V
   CREATIVITY	K R IY EY T IH V AH T IY
   CREATURE	K R IY CH ER
   CREDIBILITY	K R EH D AH B IH L AH T IY
   CREDIT	K R EH D AH T
   CREW	K R UW
   CRIME	K R AY M
   CRIMINAL	K R IH M AH N AH L
   CRISIS	K R AY S AH S
   CRITERIA	K R AY T IH R IY AH
   CRITIC	K R IH T IH K
   CRITICAL	K R IH T IH K AH L
   CRITICISM	K R IH T AH S IH Z AH M
   CRITICIZE	K R IH T AH S AY Z
   CROP	K R AA P
   CROSS	K R AO S
   CROWD	K R AW D
   CROWDED	K R AW D IH D
   CRUCIAL	K R UW SH AH L
   CRUEL	K R UW AH L
   CRUISE	K R UW Z
   CRUSH	K R AH SH
   CRY	K R AY
   CRYSTAL	K R IH S T AH L
   CUBAN	K Y UW B AH N
   CUE	K Y UW
   CULTURAL	K AH L CH ER AH L
   CULTURE	K AH L CH ER
   CUP	K AH P
   CURE	K Y UH R
   CURIOSITY	K Y UH R IY AA S AH T IY
   CURIOUS	K Y UH R IY AH S
   CURRENCY	K ER AH N S IY
   CURRENT	K ER AH N T
   CURRENTLY	K ER AH N T L IY
   CURRICULUM	K AH R IH K Y AH L AH M
   CURTAIN	K ER T AH N
   CURVE	K ER V
   CUSTODY	K AH S T AH D IY
   CUSTOM	K AH S T AH M
   CUSTOMER	K AH S T AH M ER
   CUT	K AH T
   CUTE	K Y UW T
   CYCLE	S AY K AH L
   DAD	D AE D
   DAILY	D EY L IY
   DAM	D AE M
   DAMAGE	D AE M IH JH
   DAMN	D AE M
   DANCE	D AE N S
   DANCER	D AE N S ER
   DANCING	D AE N S IH NG
   DANGER	D EY N JH ER
   DANGEROUS	D EY N JH ER AH S
   DARE	D EH R
   DARK	D AA R K
   DARKNESS	D AA R K N AH S
   DATA	D EY T AH
   DATABASE	D AE T AH B EY Z
   DATE	D EY T
   DAUGHTER	D AO T ER
   DAWN	D AO N
   DAY	D EY
   DEAD	D EH D
   DEADLINE	D EH D L AY N
   DEADLY	D EH D L IY
   DEAL	D IY L
   DEALER	D IY L ER
   DEAR	D IH ER
   DEATH	D EH TH
   DEBATE	D AH B EY T
   DEBRIS	D AH B R IY
   DEBT	D EH T
   DEBUT	D EY B Y UW
   DECADE	D EH K EY D
   DECENT	D IY S AH N T
   DECIDE	D IH S AY D
   DECISION	D IH S IH ZH AH N
   DECK	D EH K
   DECLARE	D IH K L EH R
   DECLINE	D IH K L AY N
   DECORATE	D EH K AH R EY T
   DECREASE	D IH K R IY S
   DEDICATE	D EH D IH K AH T
   DEEM	D IY M
   DEEP	D IY P
   DEEPLY	D IY P L IY
   DEER	D IH ER
   DEFEAT	D IH F IY T
   DEFEND	D IY F EH N D
   DEFENDANT	D IY F EH N D AH N T
   DEFENDER	D IY F EH N D ER
   DEFENSE	D IH F EH N S
   DEFENSIVE	D IH F EH N S IH V
   DEFICIT	D EH F AH S AH T
   DEFINE	D IH F AY N
   DEFINITELY	D EH F AH N AH T L IY
   DEFINITION	D EH F AH N IH SH AH N
   DEGREE	D IH G R IY
   DELAY	D IH L EY
   DELIBERATELY	D IH L IH B AH R AH T L IY
   DELICATE	D EH L IH K AH T
   DELIGHT	D IH L AY T
   DELIVER	D IH L IH V ER
   DELIVERY	D IH L IH V AH R IY
   DEMAND	D IH M AE N D
   DEMOCRACY	D IH M AA K R AH S IY
   DEMOCRAT	D EH M AH K R AE T
   DEMOCRATIC	D EH M AH K R AE T IH K
   DEMOGRAPHIC	D EH M AH G R AE F IH K
   DEMONSTRATE	D EH M AH N S T R AH T
   DEMONSTRATION	D EH M AH N S T R EY SH AH N
   DENIAL	D IH N AY AH L
   DENSE	D EH N S
   DENSITY	D EH N S AH T IY
   DENY	D IH N AY
   DEPART	D IY P AA R T
   DEPARTMENT	D IY P AA R T M AH N T
   DEPARTURE	D IY P AA R CH ER
   DEPEND	D IH P EH N D
   DEPENDENT	D IY P EH N D EH N T
   DEPENDING	D IY P EH N D IH NG
   DEPICT	D IH P IH K T
   DEPLOY	D IH P L OY
   DEPOSIT	D AH P AA Z IH T
   DEPRESSED	D IY P R EH S T
   DEPRESSION	D IY P R EH SH AH N
   DEPTH	D EH P TH
   DEPUTY	D EH P Y AH T IY
   DERIVE	D IH R AY V
   DESCEND	D IH S EH N D
   DESCRIBE	D IY S K R AY B
   DESCRIPTION	D IY S K R IH P SH AH N
   DESERT	D EH Z ER T
   DESERVE	D IH Z ER V
   DESIGN	D IH Z AY N
   DESIGNER	D IH Z AY N ER
   DESIRE	D IH Z AY ER
   DESK	D EH S K
   DESPERATE	D EH S P R AH T
   DESPERATELY	D EH S P R AH T L IY
   DESPITE	D IH S P AY T
   DESSERT	D IH Z ER T
   DESTINATION	D EH S T AH N EY SH AH N
   DESTROY	D IH S T R OY
   DESTRUCTION	D IH S T R AH K SH AH N
   DETAIL	D IH T EY L
   DETAILED	D IH T EY L D
   DETECT	D IH T EH K T
   DETECTIVE	D IH T EH K T IH V
   DETERMINATION	D IY T ER M AH N EY SH AH N
   DETERMINE	D AH T ER M AH N
   DEVASTATING	D EH V AH S T EY T IH NG
   DEVELOP	D IH V EH L AH P
   DEVELOPER	D IH V EH L AH P ER
   DEVELOPING	D IH V EH L AH P IH NG
   DEVELOPMENT	D IH V EH L AH P M AH N T
   DEVELOPMENTAL	D IH V EH L AH P M EH N T AH L
   DEVICE	D IH V AY S
   DEVIL	D EH V AH L
   DEVOTE	D IH V OW T
   DIABETES	D AY AH B IY T IY Z
   DIAGNOSE	D AY IH G N OW S
   DIAGNOSIS	D AY IH G N OW S AH S
   DIALOGUE	D AY AH L AO G
   DIAMOND	D AY M AH N D
   DIARY	D AY AH R IY
   DICTATE	D IH K T EY T
   DIE	D AY
   DIET	D AY AH T
   DIFFER	D IH F ER
   DIFFERENCE	D IH F ER AH N S
   DIFFERENT	D IH F ER AH N T
   DIFFERENTLY	D IH F ER AH N T L IY
   DIFFICULT	D IH F IH K AH L T
   DIFFICULTY	D IH F IH K AH L T IY
   DIG	D IH G
   DIGITAL	D IH JH AH T AH L
   DIGNITY	D IH G N AH T IY
   DILEMMA	D AH L EH M AH
   DIMENSION	D AH M EH N CH AH N
   DIMINISH	D AH M IH N IH SH
   DINING	D AY N IH NG
   DINNER	D IH N ER
   DIP	D IH P
   DIPLOMAT	D IH P L AH M AE T
   DIPLOMATIC	D IH P L AH M AE T IH K
   DIRECT	D AH R EH K T
   DIRECTION	D AH R EH K SH AH N
   DIRECTLY	D AH R EH K T L IY
   DIRECTOR	D AH R EH K T ER
   DIRT	D ER T
   DIRTY	D ER T IY
   DISABILITY	D IH S AH B IH L AH T IY
   DISABLED	D IH S EY B AH L D
   DISAGREE	D IH S AH G R IY
   DISAPPEAR	D IH S AH P IH ER
   DISAPPOINTED	D IH S AH P OY N T IH D
   DISAPPOINTMENT	D IH S AH P OY N T M AH N T
   DISASTER	D IH Z AE S T ER
   DISC	D IH S K
   DISCIPLINE	D IH S AH P L AH N
   DISCLOSE	D IH S K L OW Z
   DISCOUNT	D IH S K AW N T
   DISCOURAGE	D IH S K ER IH JH
   DISCOURSE	D IH S K OW R S
   DISCOVER	D IH S K AH V ER
   DISCOVERY	D IH S K AH V AH R IY
   DISCRIMINATION	D IH S K R IH M AH N EY SH AH N
   DISCUSS	D IH S K AH S
   DISCUSSION	D IH S K AH SH AH N
   DISEASE	D IH Z IY Z
   DISH	D IH SH
   DISK	D IH S K
   DISMISS	D IH S M IH S
   DISORDER	D IH S AO R D ER
   DISPLAY	D IH S P L EY
   DISPUTE	D IH S P Y UW T
   DISSOLVE	D IH Z AA L V
   DISTANCE	D IH S T AH N S
   DISTANT	D IH S T AH N T
   DISTINCT	D IH S T IH NG K T
   DISTINCTION	D IH S T IH NG K SH AH N
   DISTINCTIVE	D IH S T IH NG K T IH V
   DISTINGUISH	D IH S T IH NG G W IH SH
   DISTRACT	D IH S T R AE K T
   DISTRIBUTE	D IH S T R IH B Y UW T
   DISTRIBUTION	D IH S T R AH B Y UW SH AH N
   DISTRICT	D IH S T R IH K T
   DISTURB	D IH S T ER B
   DISTURBING	D IH S T ER B IH NG
   DIVERSE	D AY V ER S
   DIVERSITY	D AY V ER S AH T IY
   DIVIDE	D AH V AY D
   DIVINE	D AH V AY N
   DIVISION	D AH V IH ZH AH N
   DIVORCE	D AH V OW R S
   DNA	D N AA
   DO	D UW
   DOCK	D AA K
   DOCTOR	D AA K T ER
   DOCTRINE	D AA K T R AH N
   DOCUMENT	D AA K Y AH M AH N T
   DOCUMENTARY	D AA K Y AH M EH N T AH R IY
   DOG	D AO G
   DOLL	D AA L
   DOMAIN	D OW M EY N
   DOMESTIC	D AH M EH S T IH K
   DOMINANT	D AA M AH N AH N T
   DOMINATE	D AA M AH N AH T
   DONATE	D OW N EY T
   DONATION	D OW N EY SH AH N
   DONOR	D OW N ER
   DOOR	D OW R
   DOORWAY	D OW R W EY
   DOSE	D OW S
   DOT	D AA T
   DOUBLE	D AH B AH L
   DOUBT	D AW T
   DOUGH	D OW
   DOWN	D AW N
   DOWNTOWN	D AW N T AW N
   DOZEN	D AH Z AH N
   DRAFT	D R AE F T
   DRAG	D R AE G
   DRAIN	D R EY N
   DRAMA	D R AA M AH
   DRAMATIC	D R AH M AE T IH K
   DRAMATICALLY	D R AH M AE T IH K AH L IY
   DRAW	D R AO
   DRAWER	D R AO R
   DRAWING	D R AO IH NG
   DREAM	D R IY M
   DRESS	D R EH S
   DRIED	D R AY D
   DRIFT	D R IH F T
   DRILL	D R IH L
   DRINK	D R IH NG K
   DRINKING	D R IH NG K IH NG
   DRIVE	D R AY V
   DRIVER	D R AY V ER
   DRIVEWAY	D R AY V W EY
   DRIVING	D R AY V IH NG
   DROP	D R AA P
   DROWN	D R AW N
   DRUG	D R AH G
   DRUM	D R AH M
   DRUNK	D R AH NG K
   DRY	D R AY
   DUCK	D AH K
   DUE	D UW
   DUMB	D AH M
   DUMP	D AH M P
   DURING	D Y UH R IH NG
   DUST	D AH S T
   DUTCH	D AH CH
   DUTY	D UW T IY
   DYING	D AY IH NG
   DYNAMIC	D AY N AE M IH K
   DYNAMICS	D AY N AE M IH K S
   E-MAIL	M EY L
   EACH	IY CH
   EAGER	IY G ER
   EAR	IH ER
   EARLY	ER L IY
   EARN	ER N
   EARNINGS	ER N IH NG Z
   EARTH	ER TH
   EARTHQUAKE	ER TH K W EY K
   EASE	IY Z
   EASILY	IY Z IY L IY
   EAST	IY S T
   EASTERN	IY S T ER N
   EASY	IY Z IY
   EAT	IY T
   EATING	IY T IH NG
   ECHO	EH K OW
   ECOLOGICAL	EH K AH L AA JH IH K AH L
   ECONOMIC	EH K AH N AA M IH K
   ECONOMICALLY	EH K AH N AA M IH K AH L IY
   ECONOMICS	EH K AH N AA M IH K S
   ECONOMIST	AH K AA N AH M AH S T
   ECONOMY	IH K AA N AH M IY
   ECOSYSTEM	EH K AH S IH S T AH M
   EDGE	EH JH
   EDIT	EH D AH T
   EDITION	IH D IH SH AH N
   EDITOR	EH D AH T ER
   EDUCATE	EH JH AH K AH T
   EDUCATION	EH JH AH K EY SH AH N
   EDUCATIONAL	EH JH AH K EY SH AH N AH L
   EDUCATOR	EH JH AH K AH T ER
   EFFECT	IH F EH K T
   EFFECTIVE	IH F EH K T IH V
   EFFECTIVELY	IH F EH K T IH V L IY
   EFFECTIVENESS	IH F EH K T IH V N AH S
   EFFICIENCY	IH F IH SH AH N S IY
   EFFICIENT	IH F IH SH AH N T
   EFFORT	EH F ER T
   EGG	EH G
   EGO	IY G OW
   EIGHT	EY T
   EIGHTH	EY T TH
   EITHER	IY DH ER
   ELABORATE	IH L AE B AH R AH T
   ELBOW	EH L B OW
   ELDER	EH L D ER
   ELDERLY	EH L D ER L IY
   ELECT	IH L EH K T
   ELECTION	IH L EH K SH AH N
   ELECTRIC	IH L EH K T R IH K
   ELECTRICAL	IH L EH K T R IH K AH L
   ELECTRICITY	IH L EH K T R IH S AH T IY
   ELECTRONIC	IH L EH K T R AA N IH K
   ELECTRONICS	IH L EH K T R AA N IH K S
   ELEGANT	EH L IH G AH N T
   ELEMENT	EH L AH M AH N T
   ELEMENTARY	EH L AH M EH N T R IY
   ELEPHANT	EH L AH F AH N T
   ELEVATOR	EH L AH V EY T ER
   ELEVEN	IH L EH V AH N
   ELIGIBLE	EH L IH JH AH B AH L
   ELIMINATE	IH L IH M AH N EY T
   ELITE	EY L IY T
   ELSE	EH L S
   ELSEWHERE	EH L S W EH ER
   EMBARRASSED	IH M B AE R AH S T
   EMBRACE	IH M B R EY S
   EMERGE	IH M ER JH
   EMERGENCY	IH M ER JH AH N S IY
   EMERGING	IH M ER JH IH NG
   EMISSION	IY M IH SH AH N
   EMOTION	IH M OW SH AH N
   EMOTIONAL	IH M OW SH AH N AH L
   EMOTIONALLY	IH M OW SH AH N AH L IY
   EMPHASIS	EH M F AH S AH S
   EMPHASIZE	EH M F AH S AY Z
   EMPIRE	EH M P AY ER
   EMPLOY	IH M P L OY
   EMPLOYEE	IH M P L OY IY IY
   EMPLOYER	IH M P L OY IY ER
   EMPLOYMENT	IH M P L OY M AH N T
   EMPTY	EH M P T IY
   ENABLE	EH N EY B AH L
   ENACT	EH N AE K T
   ENCOUNTER	IH N K AW N T ER
   ENCOURAGE	EH N K ER IH JH
   ENCOURAGING	EH N K ER IH JH IH NG
   END	EH N D
   ENDLESS	EH N D L AH S
   ENDORSE	IH N D AO R S
   ENDURE	EH N D Y UH R
   ENEMY	EH N AH M IY
   ENERGY	EH N ER JH IY
   ENFORCE	EH N F OW R S
   ENFORCEMENT	EH N F OW R S M AH N T
   ENGAGE	EH N G EY JH
   ENGAGEMENT	EH N G EY JH M AH N T
   ENGINE	EH N JH AH N
   ENGINEER	EH N JH AH N IH R
   ENGINEERING	EH N JH AH N IH R IH NG
   ENGLISH	IH NG G L IH SH
   ENHANCE	IH N HH AE N S
   ENJOY	EH N JH OY
   ENORMOUS	IH N AO R M AH S
   ENOUGH	IH N AH F
   ENROLL	EH N R OW L
   ENSURE	EH N SH UH R
   ENTER	EH N T ER
   ENTERPRISE	EH N T ER P R AY Z
   ENTERTAINMENT	EH N T ER T EY N M AH N T
   ENTHUSIASM	IH N TH UW Z IY AE Z AH M
   ENTIRE	IH N T AY ER
   ENTIRELY	IH N T AY ER L IY
   ENTITLE	EH N T AY T AH L
   ENTITY	EH N T AH T IY
   ENTRANCE	EH N T R AH N S
   ENTREPRENEUR	AA N T R AH P R AH N ER
   ENTRY	EH N T R IY
   ENVELOPE	EH N V AH L OW P
   ENVIRONMENT	IH N V AY R N M AH N T
   ENVIRONMENTAL	IH N V AY R AH N M EH N T AH L
   ENVISION	EH N V IH ZH AH N
   EPIDEMIC	EH P AH D EH M IH K
   EPISODE	EH P AH S OW D
   EQUAL	IY K W AH L
   EQUALITY	IH K W AA L AH T IY
   EQUALLY	IY K W AH L IY
   EQUATION	IH K W EY SH AH N
   EQUIP	IH K W IH P
   EQUIPMENT	IH K W IH P M AH N T
   EQUITY	EH K W AH T IY
   EQUIVALENT	IH K W IH V AH L AH N T
   ERA	IH R AH
   ERROR	EH R ER
   ESCAPE	IH S K EY P
   ESPECIALLY	IH S P EH SH AH L IY
   ESSAY	EH S EY
   ESSENCE	EH S AH N S
   ESSENTIAL	IH S EH N CH AH L
   ESSENTIALLY	IH S EH N CH AH L IY
   ESTABLISH	IH S T AE B L IH SH
   ESTABLISHMENT	IH S T AE B L IH SH M AH N T
   ESTATE	IH S T EY T
   ESTIMATE	EH S T AH M AH T
   ESTIMATED	EH S T AH M EY T IH D
   ETC	EH T
   ETHICAL	EH TH IH K AH L
   ETHICS	EH TH IH K S
   ETHNIC	EH TH N IH K
   EUROPEAN	Y UH R AH P IY AH N
   EVALUATE	IH V AE L Y AH W EY T
   EVALUATION	IH V AE L Y AH W EY SH AH N
   EVEN	IY V AH N
   EVENING	IY V N IH NG
   EVENT	IH V EH N T
   EVENTUALLY	IH V EH N CH AH W AH L IY
   EVER	EH V ER
   EVERY	EH V R IY
   EVERYBODY	EH V R IH B AA D IY
   EVERYDAY	EH V R IY D EY
   EVERYONE	EH V R IY W AH N
   EVERYTHING	EH V R IY TH IH NG
   EVERYWHERE	EH V R IY W EH ER
   EVIDENCE	EH V AH D AH N S
   EVIDENT	EH V AH D AH N T
   EVIL	IY V AH L
   EVOLUTION	EH V AH L UW SH AH N
   EVOLVE	IH V AA L V
   EXACT	IH G Z AE K T
   EXACTLY	IH G Z AE K T L IY
   EXAM	IH G Z AE M
   EXAMINATION	EH G Z AE M AH N EY SH AH N
   EXAMINE	EH G Z AE M AH N
   EXAMPLE	IH G Z AE M P AH L
   EXCEED	IH K S IY D
   EXCELLENT	EH K S AH L AH N T
   EXCEPT	IH K S EH P T
   EXCEPTION	IH K S EH P SH AH N
   EXCESSIVE	EH K S EH S IH V
   EXCHANGE	IH K S CH EY N JH
   EXCITED	IH K S AY T IH D
   EXCITEMENT	IH K S AY T M AH N T
   EXCITING	IH K S AY T IH NG
   EXCLUDE	IH K S K L UW D
   EXCLUSIVE	IH K S K L UW S IH V
   EXCLUSIVELY	IH K S K L UW S IH V L IY
   EXCUSE	IH K S K Y UW Z
   EXECUTE	EH K S AH K Y UW T
   EXECUTION	EH K S AH K Y UW SH AH N
   EXECUTIVE	IH G Z EH K Y AH T AH V
   EXERCISE	EH K S ER S AY Z
   EXHAUST	IH G Z AO S T
   EXHIBIT	IH G Z IH B AH T
   EXHIBITION	EH K S AH B IH SH AH N
   EXIST	EH G Z IH S T
   EXISTENCE	EH G Z IH S T AH N S
   EXISTING	EH G Z IH S T IH NG
   EXIT	EH G Z AH T
   EXOTIC	IH G Z AA T IH K
   EXPAND	IH K S P AE N D
   EXPANSION	IH K S P AE N CH AH N
   EXPECT	IH K S P EH K T
   EXPECTATION	IH K S P EH K T EY SH AH N
   EXPECTED	IH K S P EH K T IH D
   EXPEDITION	EH K S P AH D IH SH AH N
   EXPENSE	IH K S P EH N S
   EXPENSIVE	EH K S P EH N S IH V
   EXPERIENCE	IH K S P IH R IY AH N S
   EXPERIENCED	IH K S P IH R IY AH N S T
   EXPERIMENT	IH K S P EH R AH M AH N T
   EXPERIMENTAL	IH K S P EH R AH M EH N T AH L
   EXPERT	EH K S P ER T
   EXPERTISE	EH K S P ER T IY Z
   EXPLAIN	IH K S P L EY N
   EXPLANATION	EH K S P L AH N EY SH AH N
   EXPLICIT	IH K S P L IH S AH T
   EXPLODE	IH K S P L OW D
   EXPLOIT	EH K S P L OY T
   EXPLORATION	EH K S P L AH R EY SH AH N
   EXPLORE	IH K S P L OW R
   EXPLOSION	IH K S P L OW ZH AH N
   EXPORT	EH K S P OW R T
   EXPOSE	IH K S P OW Z
   EXPOSURE	IH K S P OW ZH ER
   EXPRESS	IH K S P R EH S
   EXPRESSION	IH K S P R EH SH AH N
   EXTEND	IH K S T EH N D
   EXTENDED	IH K S T EH N D IH D
   EXTENSION	IH K S T EH N CH AH N
   EXTENSIVE	IH K S T EH N S IH V
   EXTENT	EH K S T EH N T
   EXTERNAL	EH K S T ER N AH L
   EXTRA	EH K S T R AH
   EXTRAORDINARY	IH K S T R AO R D AH N EH R IY
   EXTREME	IH K S T R IY M
   EXTREMELY	IH K S T R IY M L IY
   EYE	AY
   EYEBROW	AY B R AW
   FABRIC	F AE B R IH K
   FACE	F EY S
   FACILITATE	F AH S IH L AH T AH T
   FACILITY	F AH S IH L AH T IY
   FACT	F AE K T
   FACTOR	F AE K T ER
   FACTORY	F AE K T AH R IY
   FACULTY	F AE K AH L T IY
   FADE	F EY D
   FAIL	F EY L
   FAILURE	F EY L Y ER
   FAINT	F EY N T
   FAIR	F EH R
   FAIRLY	F EH R L IY
   FAITH	F EY TH
   FALL	F AO L
   FALSE	F AO L S
   FAME	F EY M
   FAMILIAR	F AH M IH L Y ER
   FAMILY	F AE M AH L IY
   FAMOUS	F EY M AH S
   FAN	F AE N
   FANTASTIC	F AE N T AE S T IH K
   FANTASY	F AE N T AH S IY
   FAR	F AA R
   FARE	F EH R
   FARM	F AA R M
   FARMER	F AA R M ER
   FASCINATING	F AE S AH N EY T IH NG
   FASHION	F AE SH AH N
   FAST	F AE S T
   FASTER	F AE S T ER
   FAT	F AE T
   FATAL	F EY T AH L
   FATE	F EY T
   FATHER	F AA DH ER
   FATIGUE	F AH T IY G
   FAULT	F AO L T
   FAVOR	F EY V ER
   FAVORABLE	F EY V ER AH B AH L
   FAVORITE	F EY V AH R AH T
   FEAR	F IH ER
   FEATHER	F EH DH ER
   FEATURE	F IY CH ER
   FEDERAL	F EH D ER AH L
   FEE	F IY
   FEED	F IY D
   FEEDBACK	F IY D B AE K
   FEEL	F IY L
   FEELING	F IY L IH NG
   FELLOW	F EH L OW
   FEMALE	F IY M EY L
   FEMINIST	F EH M AH N AH S T
   FENCE	F EH N S
   FESTIVAL	F EH S T IH V AH L
   FEVER	F IY V ER
   FEW	F Y UW
   FEWER	F Y UW ER
   FIBER	F AY B ER
   FICTION	F IH K SH AH N
   FIELD	F IY L D
   FIERCE	F IH ER S
   FIFTEEN	F IH F T IY N
   FIFTH	F IH F TH
   FIFTY	F IH F T IY
   FIGHT	F AY T
   FIGHTER	F AY T ER
   FIGHTING	F AY T IH NG
   FIGURE	F IH G Y ER
   FILE	F AY L
   FILL	F IH L
   FILM	F IH L M
   FILTER	F IH L T ER
   FINAL	F AY N AH L
   FINALLY	F AY N AH L IY
   FINANCE	F AH N AE N S
   FINANCIAL	F AH N AE N CH AH L
   FIND	F AY N D
   FINDING	F AY N D IH NG
   FINE	F AY N
   FINGER	F IH NG G ER
   FINISH	F IH N IH SH
   FIRE	F AY ER
   FIRM	F ER M
   FIRMLY	F ER M L IY
   FIRST	F ER S T
   FISCAL	F IH S K AH L
   FISH	F IH SH
   FISHERMAN	F IH SH ER M AE N
   FISHING	F IH SH IH NG
   FIST	F IH S T
   FIT	F IH T
   FITNESS	F IH T N AH S
   FIVE	F AY V
   FIX	F IH K S
   FIXED	F IH K S T
   FLAG	F L AE G
   FLAME	F L EY M
   FLASH	F L AE SH
   FLAT	F L AE T
   FLAVOR	F L EY V ER
   FLEE	F L IY
   FLEET	F L IY T
   FLESH	F L EH SH
   FLEXIBILITY	F L EH K S AH B IH L AH T IY
   FLEXIBLE	F L EH K S AH B AH L
   FLIGHT	F L AY T
   FLIP	F L IH P
   FLOAT	F L OW T
   FLOOD	F L AH D
   FLOOR	F L OW R
   FLOUR	F L AW ER
   FLOW	F L OW
   FLOWER	F L AW ER
   FLUID	F L UW AH D
   FLY	F L AY
   FLYING	F L AY IH NG
   FOCUS	F OW K AH S
   FOG	F AA G
   FOLD	F OW L D
   FOLK	F OW K
   FOLLOW	F AA L OW
   FOLLOWING	F AA L OW IH NG
   FOOD	F UW D
   FOOL	F UW L
   FOOT	F UH T
   FOOTBALL	F UH T B AO L
   FOR	F AO R
   FORBID	F AO R B IH D
   FORCE	F OW R S
   FOREHEAD	F OW R HH EH D
   FOREIGN	F AO R AH N
   FOREIGNER	F AO R AH N ER
   FOREST	F AO R AH S T
   FOREVER	F ER EH V ER
   FORGET	F AO R G EH T
   FORGIVE	F AO R G IH V
   FORK	F AO R K
   FORM	F AO R M
   FORMAL	F AO R M AH L
   FORMAT	F AO R M AE T
   FORMATION	F AO R M EY SH AH N
   FORMER	F AO R M ER
   FORMERLY	F AO R M ER L IY
   FORMULA	F AO R M Y AH L AH
   FORTH	F OW R TH
   FORTUNATELY	F AO R CH AH N AH T L IY
   FORTUNE	F AO R CH AH N
   FORTY	F AO R T IY
   FORUM	F OW R AH M
   FORWARD	F AO R W ER D
   FOSTER	F AO S T ER
   FOUND	F AW N D
   FOUNDATION	F AW N D EY SH AH N
   FOUNDER	F AW N D ER
   FOUR	F OW R
   FOURTH	F OW R TH
   FRACTION	F R AE K SH AH N
   FRAGILE	F R AE JH AH L
   FRAGMENT	F R AE G M AH N T
   FRAME	F R EY M
   FRAMEWORK	F R EY M W ER K
   FRANCHISE	F R AE N CH AY Z
   FRANKLY	F R AE NG K L IY
   FRAUD	F R AO D
   FREE	F R IY
   FREEDOM	F R IY D AH M
   FREELY	F R IY L IY
   FREEZE	F R IY Z
   FRENCH	F R EH N CH
   FREQUENCY	F R IY K W AH N S IY
   FREQUENT	F R IY K W AH N T
   FREQUENTLY	F R IY K W AH N T L IY
   FRESH	F R EH SH
   FRESHMAN	F R EH SH M AE N
   FRIEND	F R EH N D
   FRIENDLY	F R EH N D L IY
   FRIENDSHIP	F R EH N D SH IH P
   FROM	F R AH M
   FRONT	F R AH N T
   FRONTIER	F R AH N T IH ER
   FROWN	F R AW N
   FROZEN	F R OW Z AH N
   FRUIT	F R UW T
   FRUSTRATE	F R AH S T R EY T
   FRUSTRATION	F R AH S T R EY SH AH N
   FUCKING	F AH K IH NG
   FUEL	F Y UW AH L
   FULL	F UH L
   FULL-TIME	F UH L T AY M
   FULLY	F UH L IY
   FUN	F AH N
   FUNCTION	F AH NG K SH AH N
   FUNCTIONAL	F AH NG K SH AH N AH L
   FUND	F AH N D
   FUNDAMENTAL	F AH N D AH M EH N T AH L
   FUNDING	F AH N D IH NG
   FUNERAL	F Y UW N AH R AH L
   FUNNY	F AH N IY
   FUR	F ER
   FURNITURE	F ER N IH CH ER
   FURTHERMORE	F ER DH ER M OW R
   FUTURE	F Y UW CH ER
   GAIN	G EY N
   GALAXY	G AE L AH K S IY
   GALLERY	G AE L AH R IY
   GAME	G EY M
   GANG	G AE NG
   GAP	G AE P
   GARAGE	G AH R AA ZH
   GARBAGE	G AA R B IH JH
   GARDEN	G AA R D AH N
   GARLIC	G AA R L IH K
   GAS	G AE S
   GASOLINE	G AE S AH L IY N
   GATE	G EY T
   GATHER	G AE DH ER
   GATHERING	G AE DH ER IH NG
   GAY	G EY
   GAZE	G EY Z
   GEAR	G IH ER
   GENDER	JH EH N D ER
   GENE	JH IY N
   GENERAL	JH EH N ER AH L
   GENERALLY	JH EH N ER AH L IY
   GENERATE	JH EH N ER AH T
   GENERATION	JH EH N ER EY SH AH N
   GENEROUS	JH EH N ER AH S
   GENETIC	JH AH N EH T IH K
   GENIUS	JH IY N Y AH S
   GENRE	ZH AA N R AH
   GENTLE	JH EH N T AH L
   GENTLEMAN	JH EH N T AH L M AE N
   GENTLY	JH EH N T L IY
   GENUINE	JH EH N Y AH W AH N
   GERMAN	JH ER M AH N
   GESTURE	JH EH S CH ER
   GET	G EH T
   GHOST	G OW S T
   GIANT	JH AY AH N T
   GIFT	G IH F T
   GIFTED	G IH F T IH D
   GIRL	G ER L
   GIRLFRIEND	G ER L F R EH N D
   GIVE	G IH V
   GIVEN	G IH V AH N
   GLAD	G L AE D
   GLANCE	G L AE N S
   GLASS	G L AE S
   GLIMPSE	G L IH M P S
   GLOBAL	G L OW B AH L
   GLOBE	G L OW B
   GLORY	G L OW R IY
   GLOVE	G L AH V
   GO	G OW
   GOAL	G OW L
   GOAT	G OW T
   GOD	G AA D
   GOLD	G OW L D
   GOLDEN	G OW L D AH N
   GOLF	G AA L F
   GOOD	G UH D
   GOVERN	G AH V ER N
   GOVERNMENT	G AH V ER N M AH N T
   GOVERNOR	G AH V ER N ER
   GRAB	G R AE B
   GRACE	G R EY S
   GRADE	G R EY D
   GRADUALLY	G R AE JH AH W AH L IY
   GRADUATE	G R AE JH AH W AH T
   GRADUATION	G R AE JH AH W EY SH AH N
   GRAIN	G R EY N
   GRAND	G R AE N D
   GRANDCHILD	G R AE N D CH AY L D
   GRANDFATHER	G R AE N D F AA DH ER
   GRANDMOTHER	G R AE N D M AH DH ER
   GRANDPARENT	G R AE N D P AE R AH N T
   GRANT	G R AE N T
   GRAPE	G R EY P
   GRASP	G R AE S P
   GRASS	G R AE S
   GRATEFUL	G R EY T F AH L
   GRAVE	G R EY V
   GRAVITY	G R AE V AH T IY
   GRAY	G R EY
   GREAT	G R EY T
   GREATEST	G R EY T AH S T
   GREATLY	G R EY T L IY
   GREEK	G R IY K
   GREEN	G R IY N
   GREET	G R IY T
   GRIEF	G R IY F
   GRIN	G R IH N
   GRIP	G R IH P
   GROCERY	G R OW S R IY
   GROSS	G R OW S
   GROUND	G R AW N D
   GROUP	G R UW P
   GROW	G R OW
   GROWING	G R OW IH NG
   GROWTH	G R OW TH
   GUARANTEE	G AE R AH N T IY
   GUARD	G AA R D
   GUESS	G EH S
   GUEST	G EH S T
   GUIDANCE	G AY D AH N S
   GUIDE	G AY D
   GUIDELINE	G AY D L AY N
   GUILT	G IH L T
   GUILTY	G IH L T IY
   GUITAR	G AH T AA R
   GUN	G AH N
   GUT	G AH T
   GUY	G AY
   GYM	JH IH M
   HA	HH AA
   HABIT	HH AE B AH T
   HABITAT	HH AE B AH T AE T
   HAIR	HH EH R
   HALF	HH AE F
   HALFWAY	HH AE F W EY
   HALL	HH AO L
   HALLWAY	HH AO L W EY
   HAND	HH AE N D
   HANDFUL	HH AE N D F UH L
   HANDLE	HH AE N D AH L
   HANDSOME	HH AE N S AH M
   HANG	HH AE NG
   HAPPEN	HH AE P AH N
   HAPPILY	HH AE P AH L IY
   HAPPINESS	HH AE P IY N AH S
   HAPPY	HH AE P IY
   HARASSMENT	HH AH R AE S M AH N T
   HARD	HH AA R D
   HARDLY	HH AA R D L IY
   HARDWARE	HH AA R D W EH R
   HARM	HH AA R M
   HARMONY	HH AA R M AH N IY
   HARSH	HH AA R SH
   HARVEST	HH AA R V AH S T
   HAT	HH AE T
   HATE	HH EY T
   HAUL	HH AO L
   HAVE	HH AE V
   HAY	HH EY
   HAZARD	HH AE Z ER D
   HE	HH IY
   HEAD	HH EH D
   HEADACHE	HH EH D EY K
   HEADLINE	HH EH D L AY N
   HEADQUARTERS	HH EH D K W AO R T ER Z
   HEAL	HH IY L
   HEALTH	HH EH L TH
   HEALTHY	HH EH L TH IY
   HEAR	HH IH ER
   HEARING	HH IH ER IH NG
   HEART	HH AA R T
   HEAT	HH IY T
   HEAVEN	HH EH V AH N
   HEAVILY	HH EH V AH L IY
   HEAVY	HH EH V IY
   HEEL	HH IY L
   HEIGHT	HH AY T
   HELICOPTER	HH EH L AH K AA P T ER
   HELL	HH EH L
   HELLO	HH AH L OW
   HELMET	HH EH L M AH T
   HELP	HH EH L P
   HELPFUL	HH EH L P F AH L
   HENCE	HH EH N S
   HER	HH ER
   HERB	ER B
   HERE	HH IH ER
   HERITAGE	HH EH R AH T IH JH
   HERO	HH IY R OW
   HERS	HH ER Z
   HERSELF	HH ER S EH L F
   HESITATE	HH EH Z AH T EY T
   HEY	HH EY
   HI	HH AY
   HIDDEN	HH IH D AH N
   HIDE	HH AY D
   HIGH	HH AY
   HIGH-TECH	HH AY T EH K
   HIGHLIGHT	HH AY L AY T
   HIGHLY	HH AY L IY
   HIGHWAY	HH AY W EY
   HIKE	HH AY K
   HILL	HH IH L
   HIM	HH IH M
   HIMSELF	HH IH M S EH L F
   HINT	HH IH N T
   HIP	HH IH P
   HIRE	HH AY ER
   HIS	HH IH Z
   HISPANIC	HH AY Z P AE N IH K
   HISTORIAN	HH IH S T OW R IY AH N
   HISTORIC	HH IH S T AO R IH K
   HISTORICAL	HH IH S T AO R IH K AH L
   HISTORICALLY	HH IH S T AO R IH K AH L IY
   HISTORY	HH IH S T AH R IY
   HIT	HH IH T
   HOCKEY	HH AA K IY
   HOLD	HH OW L D
   HOLE	HH OW L
   HOLIDAY	HH AA L AH D EY
   HOLY	HH OW L IY
   HOME	HH OW M
   HOMELAND	HH OW M L AE N D
   HOMELESS	HH OW M L AH S
   HOMEWORK	HH OW M W ER K
   HONEST	AA N AH S T
   HONESTLY	AA N AH S T L IY
   HONEY	HH AH N IY
   HONOR	AA N ER
   HOOK	HH UH K
   HOPE	HH OW P
   HOPEFULLY	HH OW P F AH L IY
   HORIZON	HH AH R AY Z AH N
   HORMONE	HH AO R M OW N
   HORN	HH AO R N
   HORRIBLE	HH AO R AH B AH L
   HORROR	HH AO R ER
   HORSE	HH AO R S
   HOSPITAL	HH AA S P IH T AH L
   HOST	HH OW S T
   HOSTAGE	HH AA S T IH JH
   HOSTILE	HH AA S T AH L
   HOT	HH AA T
   HOTEL	HH OW T EH L
   HOUR	AW ER
   HOUSE	HH AW S
   HOUSEHOLD	HH AW S HH OW L D
   HOUSING	HH AW Z IH NG
   HOW	HH AW
   HOWEVER	HH AW EH V ER
   HUG	HH AH G
   HUGE	HH Y UW JH
   HUH	HH UW
   HUMAN	HH Y UW M AH N
   HUMANITY	HH Y UW M AE N AH T IY
   HUMOR	HH Y UW M ER
   HUNDRED	HH AH N D R AH D
   HUNGER	HH AH NG G ER
   HUNGRY	HH AH N G R IY
   HUNT	HH AH N T
   HUNTER	HH AH N T ER
   HUNTING	HH AH N T IH NG
   HURRICANE	HH ER AH K EY N
   HURRY	HH ER IY
   HURT	HH ER T
   HUSBAND	HH AH Z B AH N D
   HYPOTHESIS	HH AY P AA TH AH S AH S
   I	AY
   ICE	AY S
   ICON	IH K AH N
   IDEA	AY D IY AH
   IDEAL	AY D IY L
   IDENTICAL	AY D EH N T IH K AH L
   IDENTIFICATION	AY D EH N T AH F AH K EY SH AH N
   IDENTIFY	AY D EH N T AH F AY
   IDENTITY	AY D EH N T AH T IY
   IDEOLOGICAL	AY D IY AH L AA JH IH K AH L
   IDEOLOGY	AY D IY AA L AH JH IY
   IE	AY
   IF	IH F
   IGNORE	IH G N OW R
   ILL	IH L
   ILLEGAL	IH L IY G AH L
   ILLNESS	IH L N AH S
   ILLUSION	IH L UW ZH AH N
   ILLUSTRATE	IH L AH S T R EY T
   IMAGE	IH M IH JH
   IMAGINATION	IH M AE JH AH N EY SH AH N
   IMAGINE	IH M AE JH AH N
   IMMEDIATE	IH M IY D IY AH T
   IMMEDIATELY	IH M IY D IY AH T L IY
   IMMIGRANT	IH M AH G R AH N T
   IMMIGRATION	IH M AH G R EY SH AH N
   IMMUNE	IH M Y UW N
   IMPACT	IH M P AE K T
   IMPLEMENT	IH M P L AH M AH N T
   IMPLEMENTATION	IH M P L AH M AH N T EY SH AH N
   IMPLICATION	IH M P L IH K EY SH AH N
   IMPLY	IH M P L AY
   IMPORT	IH M P OW R T
   IMPORTANCE	IH M P OW R T AH N S
   IMPORTANT	IH M P OW R T AH N T
   IMPORTANTLY	IH M P OW R T AH N T L IY
   IMPOSE	IH M P OW Z
   IMPOSSIBLE	IH M P AA S AH B AH L
   IMPRESS	IH M P R EH S
   IMPRESSION	IH M P R EH SH AH N
   IMPRESSIVE	IH M P R EH S IH V
   IMPROVE	IH M P R UW V
   IMPROVED	IH M P R UW V D
   IMPROVEMENT	IH M P R UW V M AH N T
   IMPULSE	IH M P AH L S
   IN	IH N
   INCENTIVE	IH N S EH N T IH V
   INCIDENT	IH N S AH D AH N T
   INCLUDE	IH N K L UW D
   INCLUDING	IH N K L UW D IH NG
   INCOME	IH N K AH M
   INCORPORATE	IH N K AO R P AH R EY T
   INCREASE	IH N K R IY S
   INCREASED	IH N K R IY S T
   INCREASING	IH N K R IY S IH NG
   INCREASINGLY	IH N K R IY S IH NG L IY
   INCREDIBLE	IH N K R EH D AH B AH L
   INCREDIBLY	IH N K R EH D AH B L IY
   INDEED	IH N D IY D
   INDEPENDENCE	IH N D IH P EH N D AH N S
   INDEPENDENT	IH N D IY P EH N D EH N T
   INDEX	IH N D EH K S
   INDIAN	IH N D IY AH N
   INDICATE	IH N D AH K AH T
   INDICATION	IH N D AH K EY SH AH N
   INDICATOR	IH N D AH K AH T ER
   INDIGENOUS	IH N D IH JH AH N AH S
   INDIVIDUAL	IH N D AH V IH JH AH W AH L
   INDUSTRIAL	IH N D AH S T R IY AH L
   INDUSTRY	IH N D AH S T R IY
   INEVITABLE	IH N EH V AH T AH B AH L
   INEVITABLY	IH N EH V AH T AH B L IY
   INFANT	IH N F AH N T
   INFECTION	IH N F EH K SH AH N
   INFLATION	IH N F L EY SH AH N
   INFLUENCE	IH N F L UW AH N S
   INFLUENTIAL	IH N F L UW EH N CH AH L
   INFORM	IH N F AO R M
   INFORMAL	IH N F AO R M AH L
   INFORMATION	IH N F ER M EY SH AH N
   INFRASTRUCTURE	IH N F R AH S T R AH K CH ER
   INGREDIENT	IH N G R IY D IY AH N T
   INHERENT	IH N HH IH R AH N T
   INHERIT	IH N HH EH R AH T
   INITIAL	IH N IH SH AH L
   INITIALLY	IH N IH SH AH L IY
   INITIATE	IH N IH SH IY AH T
   INITIATIVE	IH N IH SH AH T IH V
   INJURE	IH N JH ER
   INJURY	IH N JH AH R IY
   INMATE	IH N M EY T
   INNER	IH N ER
   INNOCENT	IH N AH S AH N T
   INNOVATION	IH N AH V EY SH AH N
   INNOVATIVE	IH N AH V EY T IH V
   INPUT	IH N P UH T
   INQUIRY	IH N K W AH R IY
   INSECT	IH N S EH K T
   INSERT	IH N S ER T
   INSIDE	IH N S AY D
   INSIGHT	IH N S AY T
   INSIST	IH N S IH S T
   INSPECTION	IH N S P EH K SH AH N
   INSPECTOR	IH N S P EH K T ER
   INSPIRATION	IH N S P AH R EY SH AH N
   INSPIRE	IH N S P AY ER
   INSTALL	IH N S T AO L
   INSTALLATION	IH N S T AH L EY SH AH N
   INSTANCE	IH N S T AH N S
   INSTANT	IH N S T AH N T
   INSTANTLY	IH N S T AH N T L IY
   INSTEAD	IH N S T EH D
   INSTINCT	IH N S T IH NG K T
   INSTITUTION	IH N S T AH T UW SH AH N
   INSTITUTIONAL	IH N S T AH T UW SH AH N AH L
   INSTRUCT	IH N S T R AH K T
   INSTRUCTION	IH N S T R AH K SH AH N
   INSTRUCTIONAL	IH N S T R AH K SH AH N AH L
   INSTRUCTOR	IH N S T R AH K T ER
   INSTRUMENT	IH N S T R AH M AH N T
   INSURANCE	IH N SH UH R AH N S
   INTACT	IH N T AE K T
   INTEGRATE	IH N T AH G R AH T
   INTEGRATED	IH N T AH G R EY T IH D
   INTEGRATION	IH N T AH G R EY SH AH N
   INTEGRITY	IH N T EH G R AH T IY
   INTELLECTUAL	IH N T AH L EH K CH AH W AH L
   INTELLIGENCE	IH N T EH L AH JH AH N S
   INTELLIGENT	IH N T EH L AH JH AH N T
   INTEND	IH N T EH N D
   INTENSE	IH N T EH N S
   INTENSITY	IH N T EH N S AH T IY
   INTENT	IH N T EH N T
   INTENTION	IH N T EH N CH AH N
   INTERACT	IH N T ER AE K T
   INTERACTION	IH N T ER AE K SH AH N
   INTEREST	IH N T R AH S T
   INTERESTED	IH N T R AH S T IH D
   INTERESTING	IH N T R AH S T IH NG
   INTERFERE	IH N T ER F IH ER
   INTERIOR	IH N T IH R IY ER
   INTERNAL	IH N T ER N AH L
   INTERNATIONAL	IH N T ER N AE SH AH N AH L
   INTERNET	IH N T ER N EH T
   INTERPRET	IH N T ER P R AH T
   INTERPRETATION	IH N T ER P R AH T EY SH AH N
   INTERRUPT	IH N T AH R AH P T
   INTERVAL	IH N T ER V AH L
   INTERVENTION	IH N T ER V EH N CH AH N
   INTERVIEW	IH N T ER V Y UW
   INTIMATE	IH N T AH M AH T
   INTO	IH N T UW
   INTRODUCE	IH N T R AH D UW S
   INTRODUCTION	IH N T R AH D AH K SH AH N
   INVADE	IH N V EY D
   INVASION	IH N V EY ZH AH N
   INVENT	IH N V EH N T
   INVENTION	IH N V EH N CH AH N
   INVENTORY	IH N V AH N T OW R IY
   INVEST	IH N V EH S T
   INVESTIGATE	IH N V EH S T AH G AH T
   INVESTIGATION	IH N V EH S T AH G EY SH AH N
   INVESTIGATOR	IH N V EH S T AH G AH T ER
   INVESTMENT	IH N V EH S T M AH N T
   INVESTOR	IH N V EH S T ER
   INVISIBLE	IH N V IH Z AH B AH L
   INVITATION	IH N V AH T EY SH AH N
   INVITE	IH N V AY T
   INVOLVE	IH N V AA L V
   INVOLVED	IH N V AA L V D
   INVOLVEMENT	IH N V AA L V M AH N T
   IRAQI	IH R AH K IY
   IRISH	AY ER IH SH
   IRON	AY ER N
   IRONICALLY	AY R AA N IH K AH L IY
   IRONY	AY R AH N IY
   ISLAM	AY Z L AE M
   ISLAMIC	AY Z L EY M IH K
   ISLAND	AY L AH N D
   ISOLATE	AY S AH L EY T
   ISOLATED	AY S AH L EY T IH D
   ISOLATION	AY S AH L EY SH AH N
   ISRAELI	IH Z R AH L IY
   ISSUE	IH SH UW
   IT	IH T
   ITALIAN	AH T AE L Y AH N
   ITEM	AY T AH M
   ITS	IH T S
   ITSELF	IH T S EH L F
   JACKET	JH AE K AH T
   JAIL	JH EY L
   JAPANESE	JH AE P AH N IY Z
   JAR	JH AA R
   JAW	JH AO
   JAZZ	JH AE Z
   JEANS	JH IY N Z
   JET	JH EH T
   JEW	JH UW
   JEWELRY	JH UW AH L R IY
   JEWISH	JH UW IH SH
   JOB	JH AA B
   JOIN	JH OY N
   JOINT	JH OY N T
   JOKE	JH OW K
   JOURNAL	JH ER N AH L
   JOURNALISM	JH ER N AH L IH Z AH M
   JOURNALIST	JH ER N AH L IH S T
   JOURNEY	JH ER N IY
   JOY	JH OY
   JUDGE	JH AH JH
   JUDGMENT	JH AH JH M AH N T
   JUDICIAL	JH UH D IH SH AH L
   JUICE	JH UW S
   JUMP	JH AH M P
   JUNGLE	JH AH NG G AH L
   JUNIOR	JH UW N Y ER
   JURISDICTION	JH UH R AH S D IH K SH AH N
   JUROR	JH UH R ER
   JURY	JH UH R IY
   JUST	JH AH S T
   JUSTICE	JH AH S T AH S
   JUSTIFY	JH AH S T AH F AY
   KEEP	K IY P
   KEY	K IY
   KICK	K IH K
   KID	K IH D
   KILL	K IH L
   KILLER	K IH L ER
   KILLING	K IH L IH NG
   KIND	K AY N D
   KING	K IH NG
   KINGDOM	K IH NG D AH M
   KISS	K IH S
   KIT	K IH T
   KITCHEN	K IH CH AH N
   KNEE	N IY
   KNEEL	N IY L
   KNIFE	N AY F
   KNOCK	N AA K
   KNOW	N OW
   KNOWLEDGE	N AA L IH JH
   KNOWN	N OW N
   KOREAN	K AO R IY AH N
   LAB	L AE B
   LABEL	L EY B AH L
   LABOR	L EY B ER
   LABORATORY	L AE B AH R AH T OW R IY
   LACK	L AE K
   LADDER	L AE D ER
   LADY	L EY D IY
   LAKE	L EY K
   LAMP	L AE M P
   LAND	L AE N D
   LANDING	L AE N D IH NG
   LANDMARK	L AE N D M AA R K
   LANDSCAPE	L AE N D S K EY P
   LANE	L EY N
   LANGUAGE	L AE NG G W IH JH
   LAP	L AE P
   LARGE	L AA R JH
   LARGELY	L AA R JH L IY
   LASER	L AA Z ER
   LAST	L AE S T
   LATE	L EY T
   LATELY	L EY T L IY
   LATER	L EY T ER
   LATIN	L AE T AH N
   LATTER	L AE T ER
   LAUGH	L AE F
   LAUGHTER	L AE F T ER
   LAUNCH	L AO N CH
   LAUNDRY	L AO N D R IY
   LAW	L AO
   LAWMAKER	L AO M EY K ER
   LAWN	L AO N
   LAWSUIT	L AO S UW T
   LAWYER	L AO Y ER
   LAY	L EY
   LAYER	L EY ER
   LEAD	L IY D
   LEADER	L IY D ER
   LEADERSHIP	L IY D ER SH IH P
   LEADING	L IY D IH NG
   LEAF	L IY F
   LEAGUE	L IY G
   LEAN	L IY N
   LEAP	L IY P
   LEARN	L ER N
   LEARNING	L ER N IH NG
   LEAST	L IY S T
   LEATHER	L EH DH ER
   LEAVE	L IY V
   LECTURE	L EH K CH ER
   LEFT	L EH F T
   LEG	L EH G
   LEGACY	L EH G AH S IY
   LEGAL	L IY G AH L
   LEGALLY	L IY G AH L IY
   LEGEND	L EH JH AH N D
   LEGISLATION	L EH JH AH S L EY SH AH N
   LEGISLATIVE	L EH JH AH S L EY T IH V
   LEGISLATOR	L EH JH AH S L EY T ER
   LEGISLATURE	L EH JH AH S L EY CH ER
   LEGITIMATE	L IH JH IH T AH M AH T
   LEMON	L EH M AH N
   LEND	L EH N D
   LENGTH	L EH NG TH
   LENS	L EH N Z
   LESS	L EH S
   LESSON	L EH S AH N
   LET	L EH T
   LETTER	L EH T ER
   LEVEL	L EH V AH L
   LIABILITY	L AY AH B IH L AH T IY
   LIBERAL	L IH B ER AH L
   LIBERTY	L IH B ER T IY
   LIBRARY	L AY B R EH R IY
   LICENSE	L AY S AH N S
   LID	L IH D
   LIE	L AY
   LIFE	L AY F
   LIFESTYLE	L AY F S T AY L
   LIFETIME	L AY F T AY M
   LIFT	L IH F T
   LIGHT	L AY T
   LIGHTING	L AY T IH NG
   LIGHTLY	L AY T L IY
   LIGHTNING	L AY T N IH NG
   LIKE	L AY K
   LIKELIHOOD	L AY K L IY HH UH D
   LIKELY	L AY K L IY
   LIKEWISE	L AY K W AY Z
   LIMB	L IH M
   LIMIT	L IH M AH T
   LIMITATION	L IH M AH T EY SH AH N
   LIMITED	L IH M AH T IH D
   LINE	L AY N
   LINK	L IH NG K
   LION	L AY AH N
   LIP	L IH P
   LIQUID	L IH K W AH D
   LIST	L IH S T
   LISTEN	L IH S AH N
   LISTENER	L IH S AH N ER
   LITERALLY	L IH T AH R AH L IY
   LITERARY	L IH T ER EH R IY
   LITERATURE	L IH T AH R AH CH UH R
   LITTLE	L IH T AH L
   LIVE	L IH V
   LIVER	L IH V ER
   LIVING	L IH V IH NG
   LOAD	L OW D
   LOAN	L OW N
   LOBBY	L AA B IY
   LOCAL	L OW K AH L
   LOCATE	L OW K AH T
   LOCATION	L OW K EY SH AH N
   LOCK	L AA K
   LOG	L AA G
   LOGIC	L AA JH IH K
   LOGICAL	L AA JH IH K AH L
   LONELY	L OW N L IY
   LONG	L AO NG
   LONG-TERM	L AO NG T ER M
   LONGTIME	L AO NG T AY M
   LOOK	L UH K
   LOOP	L UW P
   LOOSE	L UW S
   LOSE	L UW Z
   LOSS	L AO S
   LOST	L AO S T
   LOT	L AA T
   LOTS	L AA T S
   LOUD	L AW D
   LOVE	L AH V
   LOVELY	L AH V L IY
   LOVER	L AH V ER
   LOW	L OW
   LOWER	L OW ER
   LOYAL	L OY AH L
   LOYALTY	L OY AH L T IY
   LUCK	L AH K
   LUCKY	L UW S IY
   LUNCH	L AH N CH
   LUNG	L AH NG
   MACHINE	M AH SH IY N
   MAD	M AE D
   MAGAZINE	M AE G AH Z IY N
   MAGIC	M AE JH IH K
   MAGNETIC	M AE G N EH T IH K
   MAGNITUDE	M AE G N AH T UW D
   MAIL	M EY L
   MAIN	M EY N
   MAINLY	M EY N L IY
   MAINSTREAM	M EY N S T R IY M
   MAINTAIN	M EY N T EY N
   MAINTENANCE	M EY N T AH N AH N S
   MAJOR	M EY JH ER
   MAJORITY	M AH JH AO R AH T IY
   MAKE	M EY K
   MAKER	M EY K ER
   MAKEUP	M EY K AH P
   MALE	M EY L
   MALL	M AO L
   MAN	M AE N
   MANAGE	M AE N IH JH
   MANAGEMENT	M AE N IH JH M AH N T
   MANAGER	M AE N IH JH ER
   MANAGING	M AE N IH JH IH NG
   MANDATE	M AE N D EY T
   MANIPULATE	M AH N IH P Y AH L AH T
   MANNER	M AE N ER
   MANSION	M AE N CH AH N
   MANUAL	M AE N Y AH W AH L
   MANUFACTURER	M AE N Y AH F AE K CH ER ER
   MANUFACTURING	M AE N Y AH F AE K CH ER IH NG
   MANY	M EH N IY
   MAP	M AE P
   MARBLE	M AA R B AH L
   MARCH	M AA R CH
   MARGIN	M AA R JH AH N
   MARINE	M AH R IY N
   MARK	M AA R K
   MARKER	M AA R K ER
   MARKET	M AA R K AH T
   MARKETING	M AA R K AH T IH NG
   MARKETPLACE	M AA R K AH T P L EY S
   MARRIAGE	M AE R IH JH
   MARRIED	M AE R IY D
   MARRY	M AE R IY
   MASK	M AE S K
   MASS	M AE S
   MASSIVE	M AE S IH V
   MASTER	M AE S T ER
   MATCH	M AE CH
   MATE	M EY T
   MATERIAL	M AH T IH R IY AH L
   MATH	M AE TH
   MATHEMATICS	M AE TH AH M AE T IH K S
   MATTER	M AE T ER
   MAXIMUM	M AE K S AH M AH M
   MAY	M EY
   MAYBE	M EY B IY
   MAYOR	M EY ER
   ME	M IY
   MEAL	M IY L
   MEAN	M IY N
   MEANING	M IY N IH NG
   MEANINGFUL	M IY N IH NG F AH L
   MEANTIME	M IY N T AY M
   MEANWHILE	M IY N W AY L
   MEASURE	M EH ZH ER
   MEASUREMENT	M EH ZH ER M AH N T
   MEAT	M IY T
   MECHANIC	M IH K AE N IH K
   MECHANICAL	M IH K AE N IH K AH L
   MECHANISM	M EH K AH N IH Z AH M
   MEDAL	M EH D AH L
   MEDIA	M IY D IY AH
   MEDICAL	M EH D IH K AH L
   MEDICATION	M EH D IH K EY SH AH N
   MEDICINE	M EH D AH S AH N
   MEDIUM	M IY D IY AH M
   MEET	M IY T
   MEETING	M IY T IH NG
   MELT	M EH L T
   MEMBER	M EH M B ER
   MEMBERSHIP	M EH M B ER SH IH P
   MEMORY	M EH M AH R IY
   MENTAL	M EH N T AH L
   MENTALLY	M EH N T AH L IY
   MENTION	M EH N CH AH N
   MENTOR	M EH N T AO R
   MENU	M EH N Y UW
   MERCHANT	M ER CH AH N T
   MERE	M IH ER
   MERELY	M IH ER L IY
   MERIT	M EH R AH T
   MESS	M EH S
   MESSAGE	M EH S IH JH
   METAL	M EH T AH L
   METAPHOR	M EH T AH F AO R
   METER	M IY T ER
   METHOD	M EH TH AH D
   METROPOLITAN	M EH T R AH P AA L AH T AH N
   MEXICAN	M EH K S IH S AH N
   MIDDLE	M IH D AH L
   MIDDLE-CLASS	M IH D AH L K L AE S
   MIDNIGHT	M IH D N AY T
   MIDST	M IH D S T
   MIGHT	M AY T
   MIGRATION	M AY G R EY SH AH N
   MILD	M AY L D
   MILITARY	M IH L AH T EH R IY
   MILK	M IH L K
   MILL	M IH L
   MILLION	M IH L Y AH N
   MIND	M AY N D
   MINE	M AY N
   MINERAL	M IH N AH R AH L
   MINIMAL	M IH N AH M AH L
   MINIMIZE	M IH N AH M AY Z
   MINIMUM	M IH N AH M AH M
   MINISTER	M IH N AH S T ER
   MINISTRY	M IH N AH S T R IY
   MINOR	M AY N ER
   MINORITY	M AH N AO R AH T IY
   MINUTE	M IH N AH T
   MIRACLE	M IH R IH K AH L
   MIRROR	M IH R ER
   MISS	M IH S
   MISSILE	M IH S AH L
   MISSING	M IH S IH NG
   MISSION	M IH SH AH N
   MISSIONARY	M IH SH AH N EH R IY
   MISTAKE	M IH S T EY K
   MIX	M IH K S
   MIXED	M IH K S T
   MIXTURE	M IH K S CH ER
   MM-HMM	EH M HH AH M
   MOBILE	M OW B AH L
   MODE	M OW D
   MODEL	M AA D AH L
   MODERATE	M AA D AH R AH T
   MODERN	M AA D ER N
   MODEST	M AA D AH S T
   MODIFY	M AA D AH F AY
   MOLECULE	M AA L IH K Y UW L
   MOM	M AA M
   MOMENT	M OW M AH N T
   MOMENTUM	M OW M EH N T AH M
   MONEY	M AH N IY
   MONITOR	M AA N AH T ER
   MONKEY	M AH NG K IY
   MONSTER	M AA N S T ER
   MONTH	M AH N TH
   MONTHLY	M AH N TH L IY
   MONUMENT	M AA N Y AH M AH N T
   MOOD	M UW D
   MOON	M UW N
   MORAL	M AO R AH L
   MORE	M OW R
   MOREOVER	M OW R OW V ER
   MORNING	M AO R N IH NG
   MORTALITY	M AO R T AE L AH T IY
   MORTGAGE	M AO R G IH JH
   MOST	M OW S T
   MOSTLY	M OW S T L IY
   MOTHER	M AH DH ER
   MOTION	M OW SH AH N
   MOTIVATE	M OW T IH V AH T
   MOTIVATION	M OW T IH V EY SH AH N
   MOTIVE	M OW T IH V
   MOTOR	M OW T ER
   MOUNT	M AW N T
   MOUNTAIN	M AW N T AH N
   MOUSE	M AW S
   MOUTH	M AW TH
   MOVE	M UW V
   MOVEMENT	M UW V M AH N T
   MOVIE	M UW V IY
   MR	EH M R
   MRS	EH M AA R S
   MS	EH M S
   MUCH	M AH CH
   MUD	M AH D
   MULTIPLE	M AH L T AH P AH L
   MUNICIPAL	M Y UH N IH S AH P AH L
   MURDER	M ER D ER
   MUSCLE	M AH S AH L
   MUSEUM	M Y UH Z IY AH M
   MUSHROOM	M AH SH R UH M
   MUSIC	M Y UW Z IH K
   MUSICAL	M Y UW Z IH K AH L
   MUSICIAN	M Y UH Z IH SH AH N
   MUSLIM	M AH Z L AH M
   MUST	M AH S T
   MUTTER	M AH T ER
   MUTUAL	M Y UW CH AH W AH L
   MY	M AY
   MYSELF	M AY S EH L F
   MYSTERIOUS	M IH S T IH R IY AH S
   MYSTERY	M IH S T AH R IY
   MYTH	M IH TH
   N'T	EH N T
   NAIL	N EY L
   NAKED	N EY K AH D
   NAME	N EY M
   NARRATIVE	N AE R AH T IH V
   NARROW	N AE R OW
   NASTY	N AE S T IY
   NATION	N EY SH AH N
   NATIONAL	N AE SH AH N AH L
   NATIONWIDE	N EY SH AH N W AY D
   NATIVE	N EY T IH V
   NATURAL	N AE CH AH R AH L
   NATURALLY	N AE CH AH R AH L IY
   NATURE	N EY CH ER
   NAVAL	N EY V AH L
   NEAR	N IH ER
   NEARBY	N IH ER B AY
   NEARLY	N IH R L IY
   NEAT	N IY T
   NECESSARILY	N EH S AH S EH R AH L IY
   NECESSARY	N EH S AH S EH R IY
   NECESSITY	N IH S EH S AH T IY
   NECK	N EH K
   NEED	N IY D
   NEEDLE	N IY D AH L
   NEGATIVE	N EH G AH T IH V
   NEGOTIATE	N IH G OW SH IY EY T
   NEGOTIATION	N IH G OW SH IY EY SH AH N
   NEIGHBOR	N EY B ER
   NEIGHBORHOOD	N EY B ER HH UH D
   NEIGHBORING	N EY B ER IH NG
   NEITHER	N IY DH ER
   NERVE	N ER V
   NERVOUS	N ER V AH S
   NEST	N EH S T
   NET	N EH T
   NETWORK	N EH T W ER K
   NEUTRAL	N UW T R AH L
   NEVER	N EH V ER
   NEVERTHELESS	N EH V ER DH AH L EH S
   NEW	N UW
   NEWLY	N UW L IY
   NEWS	N UW Z
   NEWSPAPER	N UW Z P EY P ER
   NEXT	N EH K S T
   NICE	N AY S
   NIGHT	N AY T
   NIGHTMARE	N AY T M EH R
   NINE	N AY N
   NO	N OW
   NOBODY	N OW B AA D IY
   NOD	N AA D
   NOISE	N OY Z
   NOMINATION	N AA M AH N EY SH AH N
   NOMINEE	N AA M AH N IY
   NONE	N AH N
   NONETHELESS	N AH N DH AH L EH S
   NONPROFIT	N AA N P R AA F AH T
   NOON	N UW N
   NOR	N AO R
   NORM	N AO R M
   NORMAL	N AO R M AH L
   NORMALLY	N AO R M AH L IY
   NORTH	N AO R TH
   NORTHEAST	N AO R TH IY S T
   NORTHERN	N AO R DH ER N
   NORTHWEST	N AO R TH W EH S T
   NOSE	N OW Z
   NOT	N AA T
   NOTE	N OW T
   NOTEBOOK	N OW T B UH K
   NOTHING	N AH TH IH NG
   NOTICE	N OW T AH S
   NOTION	N OW SH AH N
   NOVEL	N AA V AH L
   NOW	N AW
   NOWHERE	N OW W EH ER
   NUCLEAR	N UW K L IY ER
   NUMBER	N AH M B ER
   NUMEROUS	N UW M ER AH S
   NURSE	N ER S
   NUT	N AH T
   NUTRIENT	N UW T R IY AH N T
   O'CLOCK	AH K L AA K
   OAK	OW K
   OBJECT	AA B JH IH K T
   OBJECTION	AA B JH IH K SH AH N
   OBJECTIVE	AA B JH IH K T IH V
   OBLIGATION	AA B L AH G EY SH AH N
   OBSERVATION	AA B S ER V EY SH AH N
   OBSERVE	AH B Z ER V
   OBSERVER	AH B Z ER V ER
   OBSTACLE	AA B S T IH K AH L
   OBTAIN	AH B T EY N
   OBVIOUS	AA B V IY AH S
   OBVIOUSLY	AA B V IY AH S L IY
   OCCASION	AH K EY ZH AH N
   OCCASIONAL	AH K EY ZH AH N AH L
   OCCASIONALLY	AH K EY ZH AH N AH L IY
   OCCUPATION	AA K Y AH P EY SH AH N
   OCCUPY	AA K Y AH P AY
   OCCUR	AH K ER
   OCEAN	OW SH AH N
   ODD	AA D
   ODDS	AA D Z
   OF	AH V
   OFF	AO F
   OFFENDER	AH F EH N D ER
   OFFENSE	AH F EH N S
   OFFENSIVE	AH F EH N S IH V
   OFFER	AO F ER
   OFFERING	AO F ER IH NG
   OFFICE	AO F AH S
   OFFICER	AO F AH S ER
   OFFICIAL	AH F IH SH AH L
   OFFICIALLY	AH F IH SH AH L IY
   OFTEN	AO F AH N
   OH	OW
   OIL	OY L
   OK	AA K
   OKAY	OW K EY
   OLD	OW L D
   OLD-FASHIONED	OW L D F AE SH AH N D
   OLYMPIC	AA L AH M P AH K
   OLYMPICS	AH L IH M P AH S Z
   ON	AO N
   ONCE	W AH N S
   ONE	W AH N
   ONE-THIRD	W AH N TH ER D
   ONGOING	AO N G OW IH NG
   ONION	AH N Y AH N
   ONLINE	AO N L AY N
   ONLY	OW N L IY
   ONTO	AO N T UW
   OPEN	OW P AH N
   OPENING	OW P AH N IH NG
   OPENLY	OW P AH N L IY
   OPERA	AA P R AH
   OPERATE	AA P ER AH T
   OPERATING	AA P ER EY T IH NG
   OPERATION	AA P ER EY SH AH N
   OPERATOR	AA P ER AH T ER
   OPINION	AH P IH N Y AH N
   OPPONENT	AH P OW N AH N T
   OPPORTUNITY	AA P ER T UW N AH T IY
   OPPOSE	AH P OW Z
   OPPOSED	AH P OW Z D
   OPPOSITE	AA P AH Z AH T
   OPPOSITION	AA P AH Z IH SH AH N
   OPT	AA P T
   OPTIMISTIC	AA P T AH M IH S T IH K
   OPTION	AA P SH AH N
   OR	AO R
   ORAL	AO R AH L
   ORANGE	AO R IH N JH
   ORBIT	AO R B AH T
   ORDER	AO R D ER
   ORDINARY	AO R D AH N EH R IY
   ORGAN	AO R G AH N
   ORGANIC	AO R G AE N IH K
   ORGANISM	AO R G AH N IH Z AH M
   ORGANIZATION	AO R G AH N AH Z EY SH AH N
   ORGANIZATIONAL	AO R G AH N AH Z EY SH AH N AH L
   ORGANIZE	AO R G AH N AY Z
   ORGANIZED	AO R G AH N AY Z D
   ORIENTATION	OW R IY EH N T EY SH AH N
   ORIGIN	AO R AH JH AH N
   ORIGINAL	AH R IH JH AH N AH L
   ORIGINALLY	AH R IH JH AH N AH L IY
   OTHER	AH DH ER
   OTHERS	AH DH ER Z
   OTHERWISE	AH DH ER W AY Z
   OUGHT	AO T
   OUR	AW ER
   OURS	AW ER Z
   OURSELVES	AW ER S EH L V Z
   OUT	AW T
   OUTCOME	AW T K AH M
   OUTDOOR	AW T D OW R
   OUTER	AW T ER
   OUTFIT	AW T F IH T
   OUTLET	AW T L EH T
   OUTLINE	AW T L AY N
   OUTPUT	AW T P UH T
   OUTSIDE	AW T S AY D
   OUTSIDER	AW T S AY D ER
   OUTSTANDING	AW T S T AE N D IH NG
   OVEN	AH V AH N
   OVER	OW V ER
   OVERALL	OW V ER AO L
   OVERCOME	OW V ER K AH M
   OVERLOOK	OW V ER L UH K
   OVERNIGHT	OW V ER N AY T
   OVERSEE	OW V ER S IY
   OVERWHELM	OW V ER W EH L M
   OVERWHELMING	OW V ER W EH L M IH NG
   OWE	OW
   OWN	OW N
   OWNER	OW N ER
   OWNERSHIP	OW N ER SH IH P
   OXYGEN	AA K S IH JH AH N
   PACE	P EY S
   PACK	P AE K
   PACKAGE	P AE S IH JH
   PAD	P AE D
   PAGE	P EY JH
   PAIN	P EY N
   PAINFUL	P EY N F AH L
   PAINT	P EY N T
   PAINTER	P EY N T ER
   PAINTING	P EY N T IH NG
   PAIR	P EH R
   PALACE	P AE L AH S
   PALE	P EY L
   PALESTINIAN	P AH L EH S T IH N IY AH N
   PALM	P AA M
   PAN	P AE N
   PANEL	P AE N AH L
   PANIC	P AE N IH K
   PANT	P AE N T
   PAPER	P EY P ER
   PARADE	P AH R EY D
   PARENT	P AE R AH N T
   PARENTAL	P AH R EH N T AH L
   PARISH	P AE R IH SH
   PARK	P AA R K
   PARKING	P AA R K IH NG
   PART	P AA R T
   PARTIAL	P AA R SH AH L
   PARTIALLY	P AA R SH AH L IY
   PARTICIPANT	P AA R T IH S AH P AH N T
   PARTICIPATE	P AA R T IH S AH P AH T
   PARTICIPATION	P AA R T IH S AH P EY SH AH N
   PARTICLE	P AA R T IH K AH L
   PARTICULAR	P AA R T IH K Y AH L ER
   PARTICULARLY	P AA R T IH K Y AH L ER L IY
   PARTLY	P AA R T L IY
   PARTNER	P AA R T N ER
   PARTNERSHIP	P AA R T N ER SH IH P
   PARTY	P AA R T IY
   PASS	P AE S
   PASSAGE	P AE S IH JH
   PASSENGER	P AE S AH N JH ER
   PASSING	P AE S IH NG
   PASSION	P AE SH AH N
   PAST	P AE S T
   PASTA	P AE S T AH
   PASTOR	P AE S T ER
   PAT	P AE T
   PATCH	P AE CH
   PATENT	P AE T AH N T
   PATH	P AE TH
   PATIENCE	P EY SH AH N S
   PATIENT	P EY SH AH N T
   PATROL	P AH T R OW L
   PATRON	P EY T R AH N
   PATTERN	P AE T ER N
   PAUSE	P AO Z
   PAY	P EY
   PAYMENT	P EY M AH N T
   PC	P IY K
   PEACE	P IY S
   PEACEFUL	P IY S F AH L
   PEAK	P IY K
   PEANUT	P IY N AH T
   PEASANT	P EH Z AH N T
   PEEL	P IY L
   PEER	P IH ER
   PEN	P EH N
   PENALTY	P EH N AH L T IY
   PENCIL	P EH N S AH L
   PENSION	P EH N CH AH N
   PEOPLE	P IY P AH L
   PEPPER	P EH P ER
   PER	P ER
   PERCEIVE	P ER S IY V
   PERCEIVED	P ER S IY V D
   PERCENTAGE	P ER S EH N T IH JH
   PERCEPTION	P ER S EH P SH AH N
   PERFECT	P ER F AH K T
   PERFECTLY	P ER F AH K T L IY
   PERFORM	P ER F AO R M
   PERFORMANCE	P ER F AO R M AH N S
   PERFORMER	P ER F AO R M ER
   PERHAPS	P ER HH AE P S
   PERIOD	P IH R IY AH D
   PERMANENT	P ER M AH N AH N T
   PERMISSION	P ER M IH SH AH N
   PERMIT	P ER M IH T
   PERSIAN	P EH R Z IY AH N
   PERSIST	P ER S IH S T
   PERSON	P ER S AH N
   PERSONAL	P ER S AH N AH L
   PERSONALITY	P ER S AH N AE L AH T IY
   PERSONALLY	P ER S AH N AH L IY
   PERSONNEL	P ER S AH N EH L
   PERSPECTIVE	P ER S P EH K T IH V
   PERSUADE	P ER S W EY D
   PET	P EH T
   PHASE	F EY Z
   PHENOMENON	F IH N AA M AH N AA N
   PHILOSOPHICAL	F IH L AH S AA F IH K AH L
   PHILOSOPHY	F AH L AA S AH F IY
   PHONE	F OW N
   PHOTO	F OW T OW
   PHOTOGRAPH	F OW T AH G R AE F
   PHOTOGRAPHER	F AH T AA G R AH F ER
   PHOTOGRAPHY	F AH T AA G R AH F IY
   PHRASE	F R EY Z
   PHYSICAL	F IH Z AH K AH L
   PHYSICALLY	F IH Z AH K AH L IY
   PHYSICIAN	F AH Z IH SH AH N
   PHYSICS	F IH Z IH K S
   PIANO	P IY AE N OW
   PICK	P IH K
   PICKUP	P IH K AH P
   PICTURE	P IH K CH ER
   PIE	P AY
   PIECE	P IY S
   PIG	P IH G
   PILE	P AY L
   PILL	P IH L
   PILLOW	P IH L OW
   PILOT	P AY L AH T
   PIN	P IH N
   PINE	P AY N
   PINK	P IH NG K
   PIONEER	P AY AH N IH ER
   PIPE	P AY P
   PISTOL	P IH S T AH L
   PIT	P IH T
   PITCH	P IH CH
   PITCHER	P IH CH ER
   PIZZA	P IY T S AH
   PLACE	P L EY S
   PLACEMENT	P L EY S M AH N T
   PLAIN	P L EY N
   PLAINTIFF	P L EY N T AH F
   PLAN	P L AE N
   PLANE	P L EY N
   PLANET	P L AE N AH T
   PLANNER	P L AE N ER
   PLANNING	P L AE N IH NG
   PLANT	P L AE N T
   PLASTIC	P L AE S T IH K
   PLATE	P L EY T
   PLATFORM	P L AE T F AO R M
   PLAY	P L EY
   PLAYER	P L EY ER
   PLAYOFF	P L EY AO F
   PLEA	P L IY
   PLEAD	P L IY D
   PLEASANT	P L EH Z AH N T
   PLEASE	P L IY Z
   PLEASED	P L IY Z D
   PLEASURE	P L EH ZH ER
   PLENTY	P L EH N T IY
   PLOT	P L AA T
   PLUNGE	P L AH N JH
   PLUS	P L AH S
   PM	P IY M
   POCKET	P AA K AH T
   POEM	P OW AH M
   POET	P OW AH T
   POETRY	P OW AH T R IY
   POINT	P OY N T
   POKE	P OW K
   POLE	P OW L
   POLICE	P AH L IY S
   POLICEMAN	P AH L IY S M AE N
   POLICY	P AA L AH S IY
   POLITICAL	P AH L IH T IH K AH L
   POLITICALLY	P AH L IH T IH K AH L IY
   POLITICIAN	P AA L AH T IH SH AH N
   POLITICS	P AA L AH T IH K S
   POLL	P OW L
   POLLUTION	P AH L UW SH AH N
   POND	P AA N D
   POOL	P UW L
   POOR	P UH R
   POP	P AA P
   POPULAR	P AA P Y AH L ER
   POPULARITY	P AA P Y AH L AE R AH T IY
   POPULATION	P AA P Y AH L EY SH AH N
   PORCH	P OW R CH
   PORK	P OW R K
   PORT	P OW R T
   PORTFOLIO	P OW R T F OW L IY OW
   PORTION	P OW R SH AH N
   PORTRAIT	P OW R T R AH T
   PORTRAY	P OW R T R EY
   POSE	P OW Z
   POSITION	P AH Z IH SH AH N
   POSITIVE	P AA Z AH T IH V
   POSSESS	P AH Z EH S
   POSSESSION	P AH Z EH SH AH N
   POSSIBILITY	P AA S AH B IH L AH T IY
   POSSIBLE	P AA S AH B AH L
   POSSIBLY	P AA S AH B L IY
   POST	P OW S T
   POSTER	P OW S T ER
   POT	P AA T
   POTATO	P AH T EY T OW
   POTENTIAL	P AH T EH N CH AH L
   POTENTIALLY	P AH T EH N CH AH L IY
   POUND	P AW N D
   POUR	P OW R
   POVERTY	P AA V ER T IY
   POWDER	P AW D ER
   POWER	P AW ER
   POWERFUL	P AW ER F AH L
   PRACTICAL	P R AE K T IH K AH L
   PRACTICALLY	P R AE K T IH K AH L IY
   PRACTICE	P R AE K T AH S
   PRACTITIONER	P R AE K T IH SH AH N ER
   PRAISE	P R EY Z
   PRAY	P R EY
   PRAYER	P R EY ER
   PREACH	P R IY CH
   PRECIOUS	P R EH SH AH S
   PRECISE	P R IH S AY S
   PRECISELY	P R IH S AY S L IY
   PREDATOR	P R IY D EY T ER
   PREDICT	P R IH D IH K T
   PREDICTION	P R IY D IH K SH AH N
   PREFER	P R IH F ER
   PREFERENCE	P R EH F AH R AH N S
   PREGNANCY	P R EH G N AH N S IY
   PREGNANT	P R EH G N AH N T
   PRELIMINARY	P R IH L IH M AH N EH R IY
   PREMISE	P R EH M AH S
   PREMIUM	P R IY M IY AH M
   PREPARATION	P R EH P AH R EY SH AH N
   PREPARE	P R IY P EH R
   PRESCRIPTION	P R IY S K R IH P SH AH N
   PRESENCE	P R EH Z AH N S
   PRESENT	P R EH Z AH N T
   PRESENTATION	P R EH Z AH N T EY SH AH N
   PRESERVE	P R IH Z ER V
   PRESIDENCY	P R EH Z AH D AH N S IY
   PRESIDENT	P R EH Z AH D AH N T
   PRESIDENTIAL	P R EH Z AH D EH N CH AH L
   PRESS	P R EH S
   PRESSURE	P R EH SH ER
   PRESUMABLY	P R IH Z UW M AH B L IY
   PRETEND	P R IY T EH N D
   PRETTY	P R IH T IY
   PREVAIL	P R IH V EY L
   PREVENT	P R IH V EH N T
   PREVENTION	P R IH V EH N CH AH N
   PREVIOUS	P R IY V IY AH S
   PREVIOUSLY	P R IY V IY AH S L IY
   PRICE	P R AY S
   PRIDE	P R AY D
   PRIEST	P R IY S T
   PRIMARILY	P R AY M EH R AH L IY
   PRIMARY	P R AY M EH R IY
   PRIME	P R AY M
   PRINCIPAL	P R IH N S AH P AH L
   PRINCIPLE	P R IH N S AH P AH L
   PRINT	P R IH N T
   PRIOR	P R AY ER
   PRIORITY	P R AY AO R AH T IY
   PRISON	P R IH Z AH N
   PRISONER	P R IH Z AH N ER
   PRIVACY	P R AY V AH S IY
   PRIVATE	P R AY V AH T
   PRIVATELY	P R AY V AH T L IY
   PRIVILEGE	P R IH V L IH JH
   PRIZE	P R AY Z
   PRO	P R OW
   PROBABLY	P R AA B AH B L IY
   PROBLEM	P R AA B L AH M
   PROCEDURE	P R OW S IY JH ER
   PROCEED	P R OW S IY D
   PROCESS	P R AA S EH S
   PROCESSING	P R AA S EH S IH NG
   PROCESSOR	P R OW S EH S ER
   PROCLAIM	P R OW K L EY M
   PRODUCE	P R AH D UW S
   PRODUCER	P R AH D UW S ER
   PRODUCT	P R AA D AH K T
   PRODUCTION	P R AA D AH K SH AH N
   PRODUCTIVE	P R AH D AH K T IH V
   PRODUCTIVITY	P R AA D AH K T IH V AH T IY
   PROFESSION	P R AH F EH SH AH N
   PROFESSIONAL	P R AH F EH SH AH N AH L
   PROFESSOR	P R AH F EH S ER
   PROFILE	P R OW F AY L
   PROFIT	P R AA F AH T
   PROFOUND	P R OW F AW N D
   PROGRAM	P R OW G R AE M
   PROGRAMMING	P R OW G R AE M IH NG
   PROGRESS	P R AA G R EH S
   PROGRESSIVE	P R AA G R EH S IH V
   PROHIBIT	P R OW HH IH B AH T
   PROJECT	P R AA JH EH K T
   PROJECTION	P R AA JH EH K SH AH N
   PROMINENT	P R AA M AH N AH N T
   PROMISE	P R AA M AH S
   PROMISING	P R AA M AH S IH NG
   PROMOTE	P R OW M OW T
   PROMOTION	P R OW M OW SH AH N
   PROMPT	P R AA M P T
   PROOF	P R UW F
   PROPER	P R AA P ER
   PROPERLY	P R AA P ER L IY
   PROPERTY	P R AA P ER T IY
   PROPORTION	P R OW P OW R SH AH N
   PROPOSAL	P R AH P OW Z AH L
   PROPOSE	P R AH P OW Z
   PROPOSED	P R AH P OW Z D
   PROSECUTION	P R AA S IH K Y UW SH AH N
   PROSECUTOR	P R AA S IH K Y UW T ER
   PROSPECT	P R AA S P EH K T
   PROTECT	P R AH T EH K T
   PROTECTION	P R AH T EH K SH AH N
   PROTECTIVE	P R AH T EH K T IH V
   PROTEIN	P R OW T IY N
   PROTEST	P R OW T EH S T
   PROTOCOL	P R OW T AH K AO L
   PROUD	P R AW D
   PROVE	P R UW V
   PROVIDE	P R AH V AY D
   PROVIDED	P R AH V AY D IH D
   PROVIDER	P R AH V AY D ER
   PROVINCE	P R AA V AH N S
   PROVISION	P R OW V IH ZH AH N
   PROVOKE	P R AH V OW K
   PSYCHOLOGICAL	S AY K AH L AA JH IH K AH L
   PSYCHOLOGIST	S AY K AA L AH JH AH S T
   PSYCHOLOGY	S AY K AA L AH JH IY
   PUBLIC	P AH B L IH K
   PUBLICATION	P AH B L IH K EY SH AH N
   PUBLICITY	P AH B L IH S AH T IY
   PUBLICLY	P AH B L IH K L IY
   PUBLISH	P AH B L IH SH
   PUBLISHER	P AH B L IH SH ER
   PULL	P UH L
   PULSE	P AH L S
   PUMP	P AH M P
   PUNCH	P AH N CH
   PUNISH	P AH N IH SH
   PUNISHMENT	P AH N IH SH M AH N T
   PURCHASE	P ER CH AH S
   PURE	P Y UH R
   PURPLE	P ER P AH L
   PURPOSE	P ER P AH S
   PURSE	P ER S
   PURSUE	P ER S UW
   PURSUIT	P ER S UW T
   PUSH	P UH SH
   PUT	P UH T
   PUZZLE	P AH Z AH L
   QUALIFY	K W AA L AH F AY
   QUALITY	K W AA L AH T IY
   QUANTITY	K W AA N T AH T IY
   QUARTER	K W AO R T ER
   QUARTERBACK	K W AO R T ER B AE K
   QUEEN	K W IY N
   QUEST	K W EH S T
   QUESTION	K W EH S CH AH N
   QUESTIONNAIRE	K W EH S CH AH N EH R
   QUICK	K W IH K
   QUICKLY	K W IH K L IY
   QUIET	K W AY AH T
   QUIETLY	K W AY AH T L IY
   QUIT	K W IH T
   QUITE	K W AY T
   QUOTE	K W OW T
   RABBIT	R AE B AH T
   RACE	R EY S
   RACIAL	R EY SH AH L
   RACISM	R EY S IH Z AH M
   RACK	R AE K
   RADAR	R EY D AA R
   RADIATION	R EY D IY EY SH AH N
   RADICAL	R AE D IH K AH L
   RADIO	R EY D IY OW
   RAGE	R EY JH
   RAIL	R EY L
   RAILROAD	R EY L R OW D
   RAIN	R EY N
   RAISE	R EY Z
   RALLY	R AE L IY
   RANCH	R AE N CH
   RANDOM	R AE N D AH M
   RANGE	R EY N JH
   RANK	R AE NG K
   RAPE	R EY P
   RAPID	R AE P AH D
   RAPIDLY	R AE P AH D L IY
   RARE	R EH R
   RARELY	R EH R L IY
   RAT	R AE T
   RATE	R EY T
   RATHER	R AE DH ER
   RATING	R EY T IH NG
   RATIO	R EY SH IY OW
   RATIONAL	R AE SH AH N AH L
   RAW	R AO
   RE	R EY
   REACH	R IY CH
   REACT	R IY AE K T
   REACTION	R IY AE K SH AH N
   READ	R IY D
   READER	R IY D ER
   READILY	R EH D AH L IY
   READING	R IY D IH NG
   READY	R EH D IY
   REAL	R IY L
   REALISTIC	R IY AH L IH S T IH K
   REALITY	R IY AE L AH T IY
   REALIZE	R IY L AY Z
   REALLY	R IY L IY
   REALM	R EH L M
   REAR	R IH ER
   REASON	R IY Z AH N
   REASONABLE	R IY Z AH N AH B AH L
   REBEL	R EH B AH L
   REBUILD	R IY B IH L D
   RECALL	R IY K AO L
   RECEIVE	R IH S IY V
   RECEIVER	R IH S IY V ER
   RECENT	R IY S AH N T
   RECENTLY	R IY S AH N T L IY
   RECEPTION	R IH S EH P SH AH N
   RECESSION	R IY S EH SH AH N
   RECIPE	R EH S AH P IY
   RECIPIENT	R IH S IH P IY AH N T
   RECOGNITION	R EH K IH G N IH SH AH N
   RECOGNIZE	R EH K AH G N AY Z
   RECOMMEND	R EH K AH M EH N D
   RECOMMENDATION	R EH K AH M AH N D EY SH AH N
   RECORD	R IH K AO R D
   RECORDING	R IH K AO R D IH NG
   RECOVER	R IH K AH V ER
   RECOVERY	R IH K AH V AH R IY
   RECRUIT	R IH K R UW T
   RED	R EH D
   REDUCE	R IH D UW S
   REDUCTION	R IY D AH K SH AH N
   REFER	R IH F ER
   REFERENCE	R EH F AH R AH N S
   REFLECT	R IH F L EH K T
   REFLECTION	R IH F L EH K SH AH N
   REFORM	R IY F AO R M
   REFRIGERATOR	R IH F R IH JH ER AH T ER
   REFUGE	R EH F Y UW JH
   REFUGEE	R EH F Y UW JH IY
   REFUSE	R IH F Y UW Z
   REGAIN	R IY G EY N
   REGARD	R IH G AA R D
   REGARDING	R IH G AA R D IH NG
   REGARDLESS	R IH G AA R D L AH S
   REGIME	R EY ZH IY M
   REGION	R IY JH AH N
   REGIONAL	R IY JH AH N AH L
   REGISTER	R EH JH AH S T ER
   REGRET	R IH G R EH T
   REGULAR	R EH G Y AH L ER
   REGULARLY	R EH G Y AH L ER L IY
   REGULATE	R EH G Y AH L AH T
   REGULATION	R EH G Y AH L EY SH AH N
   REGULATOR	R EH G Y AH L AH T ER
   REGULATORY	R EH G Y AH L AH T OW R IY
   REHABILITATION	R IY HH AH B IH L AH T EY SH AH N
   REINFORCE	R IY IH N F OW R S
   REJECT	R IH JH EH K T
   RELATE	R IH L EY T
   RELATED	R IH L EY T IH D
   RELATION	R IY L EY SH AH N
   RELATIONSHIP	R IY L EY SH AH N SH IH P
   RELATIVE	R EH L AH T IH V
   RELATIVELY	R EH L AH T IH V L IY
   RELAX	R IH L AE K S
   RELEASE	R IY L IY S
   RELEVANT	R EH L AH V AH N T
   RELIABILITY	R IY L AY AH B IH L AH T IY
   RELIABLE	R IH L AY AH B AH L
   RELIEF	R IH L IY F
   RELIEVE	R IH L IY V
   RELIGION	R IH L IH JH AH N
   RELIGIOUS	R IH L IH JH AH S
   RELUCTANT	R IH L AH K T AH N T
   RELY	R IH L AY
   REMAIN	R IH M EY N
   REMAINING	R IH M EY N IH NG
   REMARK	R IH M AA R K
   REMARKABLE	R IH M AA R K AH B AH L
   REMEMBER	R IH M EH M B ER
   REMIND	R IY M AY N D
   REMINDER	R IY M AY N D ER
   REMOTE	R IH M OW T
   REMOVAL	R IY M UW V AH L
   REMOVE	R IY M UW V
   RENDER	R EH N D ER
   RENT	R EH N T
   RENTAL	R EH N T AH L
   REPAIR	R IH P EH R
   REPEAT	R IH P IY T
   REPEATEDLY	R IH P IY T AH D L IY
   REPLACE	R IY P L EY S
   REPLACEMENT	R IY P L EY S M AH N T
   REPLY	R IH P L AY
   REPORT	R IH P OW R T
   REPORTEDLY	R IH P OW R T AH D L IY
   REPORTER	R IH P OW R T ER
   REPORTING	R IH P OW R T IH NG
   REPRESENT	R EH P R IH Z EH N T
   REPRESENTATION	R EH P R IH Z EH N T EY SH AH N
   REPRESENTATIVE	R EH P R IH Z EH N T AH T IH V
   REPUBLIC	R IY P AH B L IH K
   REPUBLICAN	R IH P AH B L IH K AH N
   REPUTATION	R EH P Y AH T EY SH AH N
   REQUEST	R IY K W EH S T
   REQUIRE	R IH K W AY ER
   REQUIRED	R IH K W AY ER D
   REQUIREMENT	R IH K W AY ER M AH N T
   RESCUE	R EH S K Y UW
   RESEARCH	R IY S ER CH
   RESEARCHER	R IY S ER CH ER
   RESEMBLE	R IH Z EH M B AH L
   RESERVATION	R EH Z ER V EY SH AH N
   RESERVE	R IH Z ER V
   RESIDENCE	R EH Z AH D AH N S
   RESIDENT	R EH Z AH D AH N T
   RESIDENTIAL	R EH Z AH D EH N CH AH L
   RESIGN	R IH Z AY N
   RESIST	R IH Z IH S T
   RESISTANCE	R IH Z IH S T AH N S
   RESOLUTION	R EH Z AH L UW SH AH N
   RESOLVE	R IH Z AA L V
   RESORT	R IH Z AO R T
   RESOURCE	R IY S OW R S
   RESPECT	R IH S P EH K T
   RESPECTIVELY	R IH S P EH K T IH V L IY
   RESPOND	R IH S P AA N D
   RESPONDENT	R IH S P AA N D AH N T
   RESPONSE	R IH S P AA N S
   RESPONSIBILITY	R IH S P AA N S AH B IH L AH T IY
   RESPONSIBLE	R IH S P AA N S AH B AH L
   REST	R EH S T
   RESTAURANT	R EH S T AH R AA N T
   RESTORE	R IY S T OW R
   RESTRICT	R IY S T R IH K T
   RESTRICTION	R IY S T R IH K SH AH N
   RESULT	R IH Z AH L T
   RESUME	R IH Z UW M
   RETAIL	R IY T EY L
   RETAILER	R IY T EY L ER
   RETAIN	R IH T EY N
   RETIRE	R IH T AY ER
   RETIRED	R IH T AY ER D
   RETIREMENT	R IH T AY ER M AH N T
   RETREAT	R IY T R IY T
   RETURN	R IY T ER N
   REVEAL	R IH V IY L
   REVELATION	R EH V AH L EY SH AH N
   REVENUE	R EH V AH N UW
   REVERSE	R IH V ER S
   REVIEW	R IY V Y UW
   REVOLUTION	R EH V AH L UW SH AH N
   REVOLUTIONARY	R EH V AH L UW SH AH N EH R IY
   REWARD	R IH W AO R D
   RHETORIC	R EH T AH R IH K
   RHYTHM	R IH DH AH M
   RIB	R IH B
   RIBBON	R IH B AH N
   RICE	R AY S
   RICH	R IH CH
   RID	R IH D
   RIDE	R AY D
   RIDER	R AY D ER
   RIDGE	R IH JH
   RIDICULOUS	R AH D IH K Y AH L AH S
   RIFLE	R AY F AH L
   RIGHT	R AY T
   RIM	R IH M
   RING	R IH NG
   RIOT	R AY AH T
   RISE	R AY Z
   RISK	R IH S K
   RISKY	R IH S K IY
   RITUAL	R IH CH AH W AH L
   RIVAL	R AY V AH L
   RIVER	R IH V ER
   ROAD	R OW D
   ROBOT	R OW B AA T
   ROCK	R AA K
   ROCKET	R AA K AH T
   ROD	R AA D
   ROLE	R OW L
   ROLL	R OW L
   ROLLING	R OW L IH NG
   ROMAN	R OW M AH N
   ROMANCE	R OW M AE N S
   ROMANTIC	R OW M AE N T IH K
   ROOF	R UW F
   ROOM	R UW M
   ROOT	R UW T
   ROPE	R OW P
   ROSE	R OW Z
   ROUGH	R AH F
   ROUGHLY	R AH F L IY
   ROUND	R AW N D
   ROUTE	R UW T
   ROUTINE	R UW T IY N
   ROUTINELY	R UW T IY N L IY
   ROW	R OW
   ROYAL	R OY AH L
   RUB	R AH B
   RUBBER	R AH B ER
   RUIN	R UW AH N
   RULE	R UW L
   RULING	R UW L IH NG
   RUMOR	R UW M ER
   RUN	R AH N
   RUNNER	R AH N ER
   RUNNING	R AH N IH NG
   RURAL	R UH R AH L
   RUSH	R AH SH
   RUSSIAN	R AH SH AH N
   SACK	S AE K
   SACRED	S EY K R AH D
   SACRIFICE	S AE K R AH F AY S
   SAD	S AE D
   SAFE	S EY F
   SAFELY	S EY F L IY
   SAFETY	S EY F T IY
   SAIL	S EY L
   SAKE	S EY K
   SALAD	S AE L AH D
   SALARY	S AE L AH R IY
   SALE	S EY L
   SALES	S EY L Z
   SALMON	S AE M AH N
   SALT	S AO L T
   SAME	S EY M
   SAMPLE	S AE M P AH L
   SANCTION	S AE NG K SH AH N
   SAND	S AE N D
   SANDWICH	S AE N D W IH CH
   SATELLITE	S AE T AH L AY T
   SATISFACTION	S AE T AH S F AE K SH AH N
   SATISFY	S AE T AH S F AY
   SAUCE	S AO S
   SAVE	S EY V
   SAVING	S EY V IH NG
   SAY	S EY
   SCALE	S K EY L
   SCAN	S K AE N
   SCANDAL	S K AE N D AH L
   SCARE	S K EH R
   SCARED	S K EH R D
   SCARY	S K EH R IY
   SCATTER	S K AE T ER
   SCENARIO	S AH N AE R IY OW
   SCENE	S IY N
   SCENT	S EH N T
   SCHEDULE	S K EH JH UW L
   SCHEME	S K IY M
   SCHOLAR	S K AA L ER
   SCHOLARSHIP	S K AA L ER SH IH P
   SCHOOL	S K UW L
   SCIENCE	S AY AH N S
   SCIENTIFIC	S AY AH N T IH F IH K
   SCIENTIST	S AY AH N T IH S T
   SCOPE	S K OW P
   SCORE	S K OW R
   SCRAMBLE	S K R AE M B AH L
   SCRATCH	S K R AE CH
   SCREAM	S K R IY M
   SCREEN	S K R IY N
   SCREENING	S K R IY N IH NG
   SCREW	S K R UW
   SCRIPT	S K R IH P T
   SCULPTURE	S K AH L P CH ER
   SEA	S IY
   SEAL	S IY L
   SEARCH	S ER CH
   SEASON	S IY Z AH N
   SEAT	S IY T
   SECOND	S EH K AH N D
   SECONDARY	S EH K AH N D EH R IY
   SECRET	S IY K R AH T
   SECRETARY	S EH K R AH T EH R IY
   SECTION	S EH K SH AH N
   SECTOR	S EH K T ER
   SECULAR	S EH K Y AH L ER
   SECURE	S IH K Y UH R
   SECURITY	S IH K Y UH R AH T IY
   SEE	S IY
   SEED	S IY D
   SEEK	S IY K
   SEEM	S IY M
   SEEMINGLY	S IY M IH NG L IY
   SEGMENT	S EH G M AH N T
   SEIZE	S IY Z
   SELDOM	S EH L D AH M
   SELECT	S AH L EH K T
   SELECTED	S AH L EH K T IH D
   SELECTION	S AH L EH K SH AH N
   SELF	S EH L F
   SELF-ESTEEM	S EH L F EH S T IY M
   SELL	S EH L
   SELLER	S EH L ER
   SEMINAR	S EH M AH N ER
   SENATE	S EH N AH T
   SENATOR	S EH N AH T ER
   SEND	S EH N D
   SENIOR	S IY N Y ER
   SENSATION	S EH N S EY SH AH N
   SENSE	S EH N S
   SENSITIVE	S EH N S AH T IH V
   SENSITIVITY	S EH N S AH T IH V AH T IY
   SENSOR	S EH N S ER
   SENTENCE	S EH N T AH N S
   SENTIMENT	S EH N T AH M AH N T
   SEPARATE	S EH P ER AH T
   SEPARATION	S EH P ER EY SH AH N
   SEQUENCE	S IY K W AH N S
   SERIES	S IH ER IY Z
   SERIOUS	S IH R IY AH S
   SERIOUSLY	S IH R IY AH S L IY
   SERVANT	S ER V AH N T
   SERVE	S ER V
   SERVICE	S ER V AH S
   SERVING	S ER V IH NG
   SESSION	S EH SH AH N
   SET	S EH T
   SETTING	S EH T IH NG
   SETTLE	S EH T AH L
   SETTLEMENT	S EH T AH L M AH N T
   SEVEN	S EH V AH N
   SEVENTH	S EH V AH N TH
   SEVERAL	S EH V R AH L
   SEVERE	S AH V IH ER
   SEVERELY	S AH V IH ER L IY
   SEX	S EH K S
   SEXUAL	S EH K SH AH W AH L
   SEXUALITY	S EH K SH AH W AE L AH T IY
   SEXUALLY	S EH K SH AH W AH L IY
   SEXY	S EH K S IY
   SHADE	SH EY D
   SHADOW	SH AE D OW
   SHAKE	SH EY K
   SHALL	SH AE L
   SHALLOW	SH AE L OW
   SHAME	SH EY M
   SHAPE	SH EY P
   SHARE	SH EH R
   SHARED	SH EH R D
   SHAREHOLDER	SH EH R HH OW L D ER
   SHARK	SH AA R K
   SHARP	SH AA R P
   SHARPLY	SH AA R P L IY
   SHE	SH IY
   SHED	SH EH D
   SHEEP	SH IY P
   SHEER	SH IH ER
   SHEET	SH IY T
   SHELF	SH EH L F
   SHELL	SH EH L
   SHELTER	SH EH L T ER
   SHIFT	SH IH F T
   SHINE	SH AY N
   SHIP	SH IH P
   SHIRT	SH ER T
   SHIT	SH IH T
   SHOCK	SH AA K
   SHOE	SH UW
   SHOOT	SH UW T
   SHOOTING	SH UW T IH NG
   SHOP	SH AA P
   SHOPPING	SH AA P IH NG
   SHORE	SH OW R
   SHORT	SH AO R T
   SHORT-TERM	SH AO R T T ER M
   SHORTAGE	SH AO R T IH JH
   SHORTLY	SH AO R T L IY
   SHORTS	SH AO R T S
   SHOT	SH AA T
   SHOULD	SH UH D
   SHOULDER	SH OW L D ER
   SHOUT	SH AW T
   SHOVE	SH AH V
   SHOW	SH OW
   SHOWER	SH AW ER
   SHRIMP	SH R IH M P
   SHRINK	SH R IH NG K
   SHRUG	SH R AH G
   SHUT	SH AH T
   SHUTTLE	SH AH T AH L
   SHY	SH AY
   SIBLING	S IH B L IH NG
   SICK	S IH K
   SIDE	S AY D
   SIDEWALK	S AY D W AO K
   SIGH	S AY
   SIGHT	S AY T
   SIGN	S AY N
   SIGNAL	S IH G N AH L
   SIGNATURE	S IH G N AH CH UH R
   SIGNIFICANCE	S IH G N IH F IH K AH N S
   SIGNIFICANT	S IH G N IH F IH K AH N T
   SIGNIFICANTLY	S IH G N IH F IH K AH N T L IY
   SILENCE	S AY L AH N S
   SILENT	S AY L AH N T
   SILK	S IH L K
   SILLY	S IH L IY
   SILVER	S IH L V ER
   SIMILAR	S IH M AH L ER
   SIMILARITY	S IH M AH L AE R AH T IY
   SIMILARLY	S IH M AH L ER L IY
   SIMPLE	S IH M P AH L
   SIMPLY	S IH M P L IY
   SIMULTANEOUSLY	S AY M AH L T EY N IY AH S L IY
   SIN	S IH N
   SINCE	S IH N S
   SING	S IH NG
   SINGER	S IH NG ER
   SINGLE	S IH NG G AH L
   SINK	S IH NG K
   SIR	S ER
   SISTER	S IH S T ER
   SIT	S IH T
   SITE	S AY T
   SITUATION	S IH CH AH W EY SH AH N
   SIX	S IH K S
   SIXTH	S IH K S TH
   SIZE	S AY Z
   SKI	S K IY
   SKILL	S K IH L
   SKILLED	S K IH L D
   SKIN	S K IH N
   SKIP	S K IH P
   SKIRT	S K ER T
   SKULL	S K AH L
   SKY	S K AY
   SLAM	S L AE M
   SLAP	S L AE P
   SLAVE	S L EY V
   SLAVERY	S L EY V AH R IY
   SLEEP	S L IY P
   SLEEVE	S L IY V
   SLICE	S L AY S
   SLIDE	S L AY D
   SLIGHT	S L AY T
   SLIGHTLY	S L AY T L IY
   SLIP	S L IH P
   SLOPE	S L OW P
   SLOT	S L AA T
   SLOW	S L OW
   SLOWLY	S L OW L IY
   SMALL	S M AO L
   SMART	S M AA R T
   SMELL	S M EH L
   SMILE	S M AY L
   SMOKE	S M OW K
   SMOOTH	S M UW DH
   SNAKE	S N EY K
   SNAP	S N AE P
   SNEAK	S N IY K
   SNOW	S N OW
   SO	S OW
   SO-CALLED	S OW K AO L D
   SOAK	S OW K
   SOAP	S OW P
   SOAR	S OW R
   SOCCER	S AA K ER
   SOCIAL	S OW SH AH L
   SOCIALLY	S OW SH AH L IY
   SOCIETY	S AH S AY AH T IY
   SOCK	S AA K
   SODIUM	S OW D IY AH M
   SOFA	S OW F AH
   SOFT	S AO F T
   SOFTEN	S AO F AH N
   SOFTLY	S AO F T L IY
   SOFTWARE	S AO F T W EH R
   SOIL	S OY L
   SOLAR	S OW L ER
   SOLDIER	S OW L JH ER
   SOLE	S OW L
   SOLELY	S OW L IY
   SOLID	S AA L AH D
   SOLUTION	S AH L UW SH AH N
   SOLVE	S AA L V
   SOME	S AH M
   SOMEBODY	S AH M B AA D IY
   SOMEDAY	S AH M D EY
   SOMEHOW	S AH M HH AW
   SOMEONE	S AH M W AH N
   SOMETHING	S AH M TH IH NG
   SOMETIME	S AH M T AY M
   SOMETIMES	S AH M T AY M Z
   SOMEWHAT	S AH M W AH T
   SOMEWHERE	S AH M W EH ER
   SON	S AH N
   SONG	S AO NG
   SOON	S UW N
   SOPHISTICATED	S AA F IH S T IH K EY T IH D
   SORRY	S AA R IY
   SORT	S AO R T
   SOUL	S OW L
   SOUND	S AW N D
   SOUP	S UW P
   SOURCE	S OW R S
   SOUTH	S AW TH
   SOUTHEAST	S AW TH IY S T
   SOUTHERN	S AH DH ER N
   SOUTHWEST	S AW TH W EH S T
   SOVEREIGNTY	S AA V R AH N T IY
   SOVIET	S OW V IY EH T
   SPACE	S P EY S
   SPANISH	S P AE N IH SH
   SPARE	S P EH R
   SPARK	S P AA R K
   SPEAK	S P IY K
   SPEAKER	S P IY K ER
   SPECIAL	S P EH SH AH L
   SPECIALIST	S P EH SH AH L IH S T
   SPECIALIZE	S P EH SH AH L AY Z
   SPECIALTY	S P EH SH AH L T IY
   SPECIES	S P IY SH IY Z
   SPECIFIC	S P IH S IH F IH K
   SPECIFICALLY	S P IH S IH F IH K AH L IY
   SPECIFY	S P EH K AH F AY
   SPECTACULAR	S P EH K T AE K Y AH L ER
   SPECTRUM	S P EH K T R AH M
   SPECULATE	S P EH K Y AH L AH T
   SPECULATION	S P EH K Y AH L EY SH AH N
   SPEECH	S P IY CH
   SPEED	S P IY D
   SPELL	S P EH L
   SPEND	S P EH N D
   SPENDING	S P EH N D IH NG
   SPHERE	S F IH ER
   SPILL	S P IH L
   SPIN	S P IH N
   SPINE	S P AY N
   SPIRIT	S P IH R AH T
   SPIRITUAL	S P IH R IH CH AH W AH L
   SPIT	S P IH T
   SPITE	S P AY T
   SPLIT	S P L IH T
   SPOKESMAN	S P OW K S M AE N
   SPONSOR	S P AA N S ER
   SPOON	S P UW N
   SPORT	S P OW R T
   SPOT	S P AA T
   SPOUSE	S P AW S
   SPRAY	S P R EY
   SPREAD	S P R EH D
   SPRING	S P R IH NG
   SPRINKLE	S P R IH NG K AH L
   SPY	S P AY
   SQUAD	S K W AA D
   SQUARE	S K W EH R
   SQUEEZE	S K W IY Z
   STABILITY	S T AH B IH L AH T IY
   STABLE	S T EY B AH L
   STACK	S T AE K
   STADIUM	S T EY D IY AH M
   STAFF	S T AE F
   STAGE	S T EY JH
   STAIR	S T EH R
   STAKE	S T EY K
   STANCE	S T AE N S
   STAND	S T AE N D
   STANDARD	S T AE N D ER D
   STANDING	S T AE N D IH NG
   STAR	S T AA R
   STARE	S T EH R
   START	S T AA R T
   STARTER	S T AA R T ER
   STARTING	S T AA R T IH NG
   STATE	S T EY T
   STATEMENT	S T EY T M AH N T
   STATION	S T EY SH AH N
   STATISTICAL	S T AH T IH S T IH K AH L
   STATISTICS	S T AH T IH S T IH K S
   STATUE	S T AE CH UW
   STATUS	S T AE T AH S
   STATUTE	S T AE CH UW T
   STAY	S T EY
   STEADILY	S T EH D IY L IY
   STEADY	S T EH D IY
   STEAK	S T EY K
   STEAL	S T IY L
   STEAM	S T IY M
   STEEL	S T IY L
   STEEP	S T IY P
   STEER	S T IH ER
   STEM	S T EH M
   STEP	S T EH P
   STEREOTYPE	S T EH R IY AH T AY P
   STICK	S T IH K
   STIFF	S T IH F
   STILL	S T IH L
   STIMULATE	S T IH M Y AH L AH T
   STIMULUS	S T IH M Y AH L AH S
   STIR	S T ER
   STOCK	S T AA K
   STOMACH	S T AH M AH K
   STONE	S T OW N
   STOP	S T AA P
   STORAGE	S T OW R IH JH
   STORE	S T OW R
   STORM	S T AO R M
   STORY	S T OW R IY
   STOVE	S T OW V
   STRAIGHT	S T R EY T
   STRAIGHTEN	S T R EY T AH N
   STRAIN	S T R EY N
   STRANGE	S T R EY N JH
   STRANGER	S T R EY N JH ER
   STRATEGIC	S T R AH T IY JH IH K
   STRATEGY	S T R AE T AH JH IY
   STRAW	S T R AO
   STREAK	S T R IY K
   STREAM	S T R IY M
   STREET	S T R IY T
   STRENGTH	S T R EH NG TH
   STRENGTHEN	S T R EH NG TH AH N
   STRESS	S T R EH S
   STRETCH	S T R EH CH
   STRICT	S T R IH K T
   STRICTLY	S T R IH K T L IY
   STRIKE	S T R AY K
   STRIKING	S T R AY K IH NG
   STRING	S T R IH NG
   STRIP	S T R IH P
   STROKE	S T R OW K
   STRONG	S T R AO NG
   STRONGLY	S T R AO NG L IY
   STRUCTURAL	S T R AH K CH ER AH L
   STRUCTURE	S T R AH K CH ER
   STRUGGLE	S T R AH G AH L
   STUDENT	S T UW D AH N T
   STUDIO	S T UW D IY OW
   STUDY	S T AH D IY
   STUFF	S T AH F
   STUMBLE	S T AH M B AH L
   STUPID	S T UW P AH D
   STYLE	S T AY L
   SUBJECT	S AH B JH IH K T
   SUBMIT	S AH B M IH T
   SUBSEQUENT	S AH B S IH K W AH N T
   SUBSIDY	S AH B S AH D IY
   SUBSTANCE	S AH B S T AH N S
   SUBSTANTIAL	S AH B S T AE N CH AH L
   SUBSTANTIALLY	S AH B S T AE N CH AH L IY
   SUBTLE	S AH T AH L
   SUBURB	S AH B ER B
   SUBURBAN	S AH B ER B AH N
   SUCCEED	S AH K S IY D
   SUCCESS	S AH K S EH S
   SUCCESSFUL	S AH K S EH S F AH L
   SUCCESSFULLY	S AH K S EH S F AH L IY
   SUCH	S AH CH
   SUCK	S AH K
   SUDDEN	S AH D AH N
   SUDDENLY	S AH D AH N L IY
   SUE	S UW
   SUFFER	S AH F ER
   SUFFERING	S AH F ER IH NG
   SUFFICIENT	S AH F IH SH AH N T
   SUGAR	SH UH G ER
   SUGGEST	S AH G JH EH S T
   SUGGESTION	S AH G JH EH S SH AH N
   SUICIDE	S UW AH S AY D
   SUIT	S UW T
   SUITABLE	S W IY T AH B AH L
   SUITE	S W IY T
   SUM	S AH M
   SUMMARY	S AH M EH R IY
   SUMMER	S AH M ER
   SUMMIT	S AH M AH T
   SUN	S AH N
   SUNLIGHT	S AH N L AY T
   SUNNY	S AH N IY
   SUPER	S UW P ER
   SUPERIOR	S UH P IH R IY ER
   SUPERMARKET	S UW P ER M AA R K AH T
   SUPERVISOR	S UW P ER V IH Z ER
   SUPPLIER	S AH P L AY ER
   SUPPLY	S AH P L AY
   SUPPORT	S AH P OW R T
   SUPPORTER	S AH P OW R T ER
   SUPPORTIVE	S AH P OW R T IH V
   SUPPOSE	S AH P OW Z
   SUPPOSED	S AH P OW Z D
   SUPPOSEDLY	S AH P OW Z AH D L IY
   SUPREME	S UH P R IY M
   SURE	SH UH R
   SURELY	SH UH R L IY
   SURFACE	S ER F AH S
   SURGEON	S ER JH AH N
   SURGERY	S ER JH AH R IY
   SURPRISE	S ER P R AY Z
   SURPRISED	S ER P R AY Z D
   SURPRISING	S ER P R AY Z IH NG
   SURPRISINGLY	S ER P R AY Z IH NG L IY
   SURROUND	S AH R AW N D
   SURROUNDING	S AH R AW N D IH NG
   SURVEILLANCE	S ER V EY L AH N S
   SURVEY	S ER V EY
   SURVIVAL	S ER V IH V AH L
   SURVIVE	S ER V AY V
   SURVIVOR	S ER V IH V ER
   SUSPECT	S AH S P EH K T
   SUSPEND	S AH S P EH N D
   SUSPICION	S AH S P IH SH AH N
   SUSPICIOUS	S AH S P IH SH AH S
   SUSTAIN	S AH S T EY N
   SUSTAINABLE	S AH S T EY N AH B AH L
   SWALLOW	S W AA L OW
   SWEAR	S W AE ER
   SWEAT	S W EH T
   SWEATER	S W EH T ER
   SWEEP	S W IY P
   SWEET	S W IY T
   SWELL	S W EH L
   SWIM	S W IH M
   SWIMMING	S W IH M IH NG
   SWING	S W IH NG
   SWITCH	S W IH CH
   SWORD	S OW R D
   SYMBOL	S IH M B AH L
   SYMBOLIC	S IH M B AA L IH K
   SYMPATHY	S IH M P AH TH IY
   SYMPTOM	S IH M P T AH M
   SYNDROME	S IH N D R OW M
   SYSTEM	S IH S T AH M
   T-SHIRT	T SH ER T
   TABLE	T EY B AH L
   TABLESPOON	T EY B AH L S P UW N
   TACKLE	T AE K AH L
   TACTIC	T AE K T IH K
   TAG	T AE G
   TAIL	T EY L
   TAKE	T EY K
   TALE	T EY L
   TALENT	T AE L AH N T
   TALENTED	T AE L AH N T IH D
   TALK	T AO K
   TALL	T AO L
   TANK	T AE NG K
   TAP	T AE P
   TAPE	T EY P
   TARGET	T AA R G AH T
   TASK	T AE S K
   TASTE	T EY S T
   TAX	T AE K S
   TAXPAYER	T AE K S P EY ER
   TEA	T IY
   TEACH	T IY CH
   TEACHER	T IY CH ER
   TEACHING	T IY CH IH NG
   TEAM	T IY M
   TEAMMATE	T IY M AH T
   TEAR	T IH ER
   TEASPOON	T IY S P UW N
   TECHNICAL	T EH K N IH K AH L
   TECHNICIAN	T EH K N IH SH AH N
   TECHNIQUE	T EH K N IY K
   TECHNOLOGICAL	T EH K N AH L AA JH IH K AH L
   TECHNOLOGY	T EH K N AA L AH JH IY
   TEEN	T IY N
   TEENAGE	T IY N IH JH
   TEENAGER	T IY N IH JH ER
   TELEPHONE	T EH L AH F OW N
   TELESCOPE	T EH L AH S K OW P
   TELEVISION	T EH L AH V IH ZH AH N
   TELL	T EH L
   TEMPERATURE	T EH M P ER AH CH ER
   TEMPLE	T EH M P AH L
   TEMPORARY	T EH M P AH R EH R IY
   TEN	T EH N
   TEND	T EH N D
   TENDENCY	T EH N D AH N S IY
   TENDER	T EH N D ER
   TENNIS	T EH N AH S
   TENSION	T EH N CH AH N
   TENT	T EH N T
   TERM	T ER M
   TERMS	T ER M Z
   TERRAIN	T AH R EY N
   TERRIBLE	T EH R AH B AH L
   TERRIBLY	T EH R AH B L IY
   TERRIFIC	T AH R IH F IH K
   TERRITORY	T EH R AH T OW R IY
   TERROR	T EH R ER
   TERRORISM	T EH R ER IH Z AH M
   TERRORIST	T EH R ER IH S T
   TEST	T EH S T
   TESTIFY	T EH S T AH F AY
   TESTIMONY	T EH S T AH M OW N IY
   TESTING	T EH S T IH NG
   TEXT	T EH K S T
   TEXTBOOK	T EH K S T B UH K
   TEXTURE	T EH K S CH ER
   THAN	DH AE N
   THANK	TH AE NG K
   THANKS	TH AE NG K S
   THANKSGIVING	TH AE NG K S G IH V IH NG
   THAT	DH AE T
   THEATER	TH IY AH T ER
   THEIR	DH EH R
   THEM	DH EH M
   THEME	TH IY M
   THEMSELVES	DH EH M S EH L V Z
   THEN	DH EH N
   THEOLOGICAL	TH IY AH L AA JH IH K AH L
   THEOLOGY	TH IY AA L AH JH IY
   THEORETICAL	TH IY AH R EH T IH K AH L
   THEORY	TH IY AH R IY
   THERAPIST	TH EH R AH P AH S T
   THERAPY	TH EH R AH P IY
   THERE	DH EH R
   THEREBY	DH AE R B AY
   THEREFORE	DH EH R F OW R
   THESE	DH IY Z
   THEY	DH EY
   THICK	TH IH K
   THIGH	TH AY
   THIN	TH IH N
   THING	TH IH NG
   THINK	TH IH NG K
   THINKING	TH IH NG K IH NG
   THIRD	TH ER D
   THIRTY	TH ER T IY
   THIS	DH IH S
   THOROUGHLY	TH ER OW L IY
   THOSE	DH OW Z
   THOUGH	DH OW
   THOUGHT	TH AO T
   THOUSAND	TH AW Z AH N D
   THREAD	TH R EH D
   THREAT	TH R EH T
   THREATEN	TH R EH T AH N
   THREE	TH R IY
   THRESHOLD	TH R EH SH OW L D
   THRIVE	TH R AY V
   THROAT	TH R OW T
   THROUGH	TH R UW
   THROUGHOUT	TH R UW AW T
   THROW	TH R OW
   THUMB	TH AH M
   THUS	DH AH S
   TICKET	T IH K AH T
   TIDE	T AY D
   TIE	T AY
   TIGHT	T AY T
   TIGHTEN	T AY T AH N
   TIGHTLY	T AY T L IY
   TILE	T AY L
   TILL	T IH L
   TIMBER	T IH M B ER
   TIME	T AY M
   TIMING	T AY M IH NG
   TINY	T AY N IY
   TIP	T IH P
   TIRE	T AY ER
   TIRED	T AY ER D
   TISSUE	T IH SH UW
   TITLE	T AY T AH L
   TO	T UW
   TOBACCO	T AH B AE K OW
   TODAY	T AH D EY
   TOE	T OW
   TOGETHER	T AH G EH DH ER
   TOILET	T OY L AH T
   TOLERANCE	T AA L ER AH N S
   TOLERATE	T AA L ER AH T
   TOLL	T OW L
   TOMATO	T AH M EY T OW
   TOMORROW	T AH M AA R OW
   TONE	T OW N
   TONGUE	T AH NG
   TONIGHT	T AH N AY T
   TOO	T UW
   TOOL	T UW L
   TOOTH	T UW TH
   TOP	T AA P
   TOPIC	T AA P IH K
   TOSS	T AO S
   TOTAL	T OW T AH L
   TOTALLY	T OW T AH L IY
   TOUCH	T AH CH
   TOUCHDOWN	T AH CH D AW N
   TOUGH	T AH F
   TOUR	T UH R
   TOURISM	T UH R IH Z AH M
   TOURIST	T UH R IH S T
   TOURNAMENT	T UH R N AH M AH N T
   TOWARD	T AH W AO R D
   TOWARDS	T AH W AO R D Z
   TOWEL	T AW AH L
   TOWER	T AW ER
   TOWN	T AW N
   TOXIC	T AA K S IH K
   TOY	T OY
   TRACE	T R EY S
   TRACK	T R AE K
   TRADE	T R EY D
   TRADING	T R EY D IH NG
   TRADITION	T R AH D IH SH AH N
   TRADITIONAL	T R AH D IH SH AH N AH L
   TRADITIONALLY	T R AH D IH SH AH N AH L IY
   TRAFFIC	T R AE F IH K
   TRAGEDY	T R AE JH AH D IY
   TRAGIC	T R AE JH IH K
   TRAIL	T R EY L
   TRAILER	T R EY L ER
   TRAIN	T R EY N
   TRAINER	T R EY N ER
   TRAINING	T R EY N IH NG
   TRAIT	T R EY T
   TRANSACTION	T R AE N S AE K SH AH N
   TRANSFER	T R AE N S F ER
   TRANSFORM	T R AE N S F AO R M
   TRANSFORMATION	T R AE N S F AO R M EY SH AH N
   TRANSIT	T R AE N Z AH T
   TRANSITION	T R AE N Z IH SH AH N
   TRANSLATE	T R AE N Z L EY T
   TRANSLATION	T R AE N S L EY SH AH N
   TRANSMISSION	T R AE N S M IH SH AH N
   TRANSMIT	T R AE N S M IH T
   TRANSPORT	T R AE N S P OW R T
   TRANSPORTATION	T R AE N S P OW R T EY SH AH N
   TRAP	T R AE P
   TRASH	T R AE SH
   TRAUMA	T R AO M AH
   TRAVEL	T R AE V AH L
   TRAVELER	T R AE V AH L ER
   TRAY	T R EY
   TREASURE	T R EH ZH ER
   TREAT	T R IY T
   TREATMENT	T R IY T M AH N T
   TREATY	T R IY T IY
   TREE	T R IY
   TREMENDOUS	T R IH M EH N D AH S
   TREND	T R EH N D
   TRIAL	T R AY AH L
   TRIBAL	T R AY B AH L
   TRIBE	T R AY B
   TRICK	T R IH K
   TRIGGER	T R IH G ER
   TRIM	T R IH M
   TRIP	T R IH P
   TRIUMPH	T R AY AH M F
   TROOP	T R UW P
   TROPICAL	T R AA P IH K AH L
   TROUBLE	T R AH B AH L
   TROUBLED	T R AH B AH L D
   TRUCK	T R AH K
   TRUE	T R UW
   TRULY	T R UW L IY
   TRUNK	T R AH NG K
   TRUST	T R AH S T
   TRUTH	T R UW TH
   TRY	T R AY
   TUBE	T UW B
   TUCK	T AH K
   TUMOR	T UW M ER
   TUNE	T UW N
   TUNNEL	T AH N AH L
   TURKEY	T ER K IY
   TURN	T ER N
   TV	T IY V
   TWELVE	T W EH L V
   TWENTIETH	T W EH N T IY IH TH
   TWENTY	T W EH N T IY
   TWICE	T W AY S
   TWIN	T W IH N
   TWIST	T W IH S T
   TWO	T UW
   TWO-THIRDS	T UW TH ER D Z
   TYPE	T AY P
   TYPICAL	T IH P IH K AH L
   TYPICALLY	T IH P IH K AH L IY
   UGLY	AH G L IY
   UH	UW
   ULTIMATE	AH L T AH M AH T
   ULTIMATELY	AH L T AH M AH T L IY
   UNABLE	AH N EY B AH L
   UNCERTAIN	AH N S ER T AH N
   UNCERTAINTY	AH N S ER T AH N T IY
   UNCLE	AH NG K AH L
   UNCOMFORTABLE	AH N K AH M F ER T AH B AH L
   UNCOVER	AH N K AH V ER
   UNDER	AH N D ER
   UNDERGO	AH N D ER G OW
   UNDERGRADUATE	AH N D ER G R AE JH AH W AH T
   UNDERLYING	AH N D ER L AY IH NG
   UNDERMINE	AH N D ER M AY N
   UNDERSTAND	AH N D ER S T AE N D
   UNDERSTANDING	AH N D ER S T AE N D IH NG
   UNDERTAKE	AH N D ER T EY K
   UNEMPLOYMENT	AH N IH M P L OY M AH N T
   UNEXPECTED	AH N IH K S P EH K T IH D
   UNFAIR	AH N F EH R
   UNFOLD	AH N F OW L D
   UNFORTUNATELY	AH N F AO R CH AH N AH T L IY
   UNHAPPY	AH N HH AE P IY
   UNIFORM	Y UW N AH F AO R M
   UNION	Y UW N Y AH N
   UNIQUE	Y UH N IY K
   UNIT	Y UW N AH T
   UNITE	Y UH N AY T
   UNITED	Y UH N AY T IH D
   UNITY	Y UW N AH T IY
   UNIVERSAL	Y UW N AH V ER S AH L
   UNIVERSE	Y UW N AH V ER S
   UNIVERSITY	Y UW N AH V ER S AH T IY
   UNKNOWN	AH N OW N
   UNLESS	AH N L EH S
   UNLIKE	AH N L AY K
   UNLIKELY	AH N L AY K L IY
   UNPRECEDENTED	AH N P R EH S AH D EH N T AH D
   UNTIL	AH N T IH L
   UNUSUAL	AH N Y UW ZH AH W AH L
   UP	AH P
   UPDATE	AH P D EY T
   UPON	AH P AA N
   UPPER	AH P ER
   UPSET	AH P S EH T
   UPSTAIRS	AH P S T AE ER Z
   URBAN	ER B AH N
   URGE	ER JH
   US	AH S
   USE	Y UW S
   USED	Y UW Z D
   USEFUL	Y UW S F AH L
   USER	Y UW S ER
   USUAL	Y UW ZH AH W AH L
   USUALLY	Y UW ZH AH W AH L IY
   UTILITY	Y UH T IH L AH T IY
   UTILIZE	Y UW T AH L AY Z
   VACATION	V EY K EY SH AH N
   VACCINE	V AE K S IY N
   VACUUM	V AE K Y UW M
   VALID	V AE L AH D
   VALIDITY	V AH L IH D AH T IY
   VALLEY	V AE L IY
   VALUABLE	V AE L Y UW AH B AH L
   VALUE	V AE L Y UW
   VAN	V AE N
   VANISH	V AE N IH SH
   VARIABLE	V AE R IY B AH L
   VARIATION	V EH R IY EY SH AH N
   VARIETY	V AH R AY AH T IY
   VARIOUS	V EH R IY AH S
   VARY	V EH R IY
   VAST	V AE S T
   VEGETABLE	V EH JH AH T AH B AH L
   VEHICLE	V IY IH K AH L
   VENDOR	V EH N D ER
   VENTURE	V EH N CH ER
   VERBAL	V ER B AH L
   VERDICT	V ER D IH K T
   VERSION	V ER ZH AH N
   VERSUS	V ER S AH S
   VERTICAL	V ER T IH K AH L
   VERY	V EH R IY
   VESSEL	V EH S AH L
   VETERAN	V EH T AH R AH N
   VIA	V AY AH
   VICTIM	V IH K T AH M
   VICTORY	V IH K T AH R IY
   VIDEO	V IH D IY OW
   VIEW	V Y UW
   VIEWER	V Y UW ER
   VILLAGE	V IH L IH JH
   VIOLATE	V AY AH L EY T
   VIOLATION	V AY AH L EY SH AH N
   VIOLENCE	V AY AH L AH N S
   VIOLENT	V AY AH L AH N T
   VIRTUAL	V IH R CH UW AH L
   VIRTUALLY	V IH R CH UW AH L IY
   VIRTUE	V IH R CH UW
   VIRUS	V AY R AH S
   VISIBLE	V IH Z AH B AH L
   VISION	V IH ZH AH N
   VISIT	V IH Z AH T
   VISITOR	V IH Z AH T ER
   VISUAL	V IH ZH AH W AH L
   VITAL	V AY T AH L
   VITAMIN	V AY T AH M AH N
   VOCAL	V OW K AH L
   VOICE	V OY S
   VOLUME	V AA L Y AH M
   VOLUNTARY	V AA L AH N T EH R IY
   VOLUNTEER	V AA L AH N T IH ER
   VOTE	V OW T
   VOTER	V OW T ER
   VOTING	V OW T IH NG
   VS	V IY S
   VULNERABLE	V AH L N ER AH B AH L
   WAGE	W EY JH
   WAGON	W AE G AH N
   WAIST	W EY S T
   WAIT	W EY T
   WAKE	W EY K
   WALK	W AO K
   WALKING	W AO K IH NG
   WALL	W AO L
   WANDER	W AA N D ER
   WANT	W AO N T
   WAR	W AO R
   WAREHOUSE	W AE ER HH AW S
   WARM	W AO R M
   WARMTH	W AO R M TH
   WARN	W AO R N
   WARNING	W AO R N IH NG
   WARRIOR	W AA R IY ER
   WASH	W AA SH
   WASTE	W EY S T
   WATCH	W AA CH
   WATER	W AO T ER
   WAVE	W EY V
   WAY	W EY
   WE	W IY
   WEAK	W IY K
   WEAKEN	W IY K AH N
   WEAKNESS	W IY K N AH S
   WEALTH	W EH L TH
   WEALTHY	W EH L TH IY
   WEAPON	W EH P AH N
   WEAR	W AE ER
   WEATHER	W EH DH ER
   WEAVE	W IY V
   WEB	W EH B
   WEDDING	W EH D IH NG
   WEED	W IY D
   WEEK	W IY K
   WEEKEND	W IY K EH N D
   WEEKLY	W IY K L IY
   WEIGH	W EY
   WEIGHT	W EY T
   WEIRD	W IH ER D
   WELCOME	W EH L K AH M
   WELFARE	W EH L F EH R
   WELL	W EH L
   WELL-BEING	W EH L B IY IH NG
   WELL-KNOWN	W EH L N OW N
   WEST	W EH S T
   WESTERN	W EH S T ER N
   WET	W EH T
   WHALE	W EY L
   WHAT	W AA T
   WHATEVER	W AA T EH V ER
   WHEAT	W IY T
   WHEEL	W IY L
   WHEELCHAIR	W IY L CH EH ER
   WHEN	W EH N
   WHENEVER	W EH N EH V ER
   WHERE	W EH ER
   WHEREAS	W EH R AE Z
   WHEREVER	W EH R EH V ER
   WHETHER	W EH DH ER
   WHICH	W IH CH
   WHILE	W AY L
   WHIP	W IH P
   WHISPER	W IH S P ER
   WHITE	W AY T
   WHO	HH UW
   WHOEVER	HH UW EH V ER
   WHOLE	HH OW L
   WHOM	HH UW M
   WHOSE	HH UW Z
   WHY	W AY
   WIDE	W AY D
   WIDELY	W AY D L IY
   WIDESPREAD	W AY D S P R EH D
   WIDOW	W IH D OW
   WIFE	W AY F
   WILD	W AY L D
   WILDERNESS	W IH L D ER N AH S
   WILDLIFE	W AY L D L AY F
   WILL	W IH L
   WILLING	W IH L IH NG
   WILLINGNESS	W IH L IH NG N AH S
   WIN	W IH N
   WIND	W IH N D
   WINDOW	W IH N D OW
   WINE	W AY N
   WING	W IH NG
   WINNER	W IH N ER
   WINTER	W IH N T ER
   WIPE	W AY P
   WIRE	W AY ER
   WISDOM	W IH Z D AH M
   WISE	W AY Z
   WISH	W IH SH
   WITH	W IH TH
   WITHDRAW	W IH TH D R AO
   WITHDRAWAL	W IH TH D R AO AH L
   WITHIN	W IH TH IH N
   WITHOUT	W IH TH AW T
   WITNESS	W IH T N AH S
   WOLF	W UH L F
   WOMAN	W UH M AH N
   WONDER	W AH N D ER
   WONDERFUL	W AH N D ER F AH L
   WOOD	W UH D
   WOODEN	W UH D AH N
   WORD	W ER D
   WORK	W ER K
   WORKER	W ER K ER
   WORKING	W ER K IH NG
   WORKOUT	W ER K AW T
   WORKPLACE	W ER K P L EY S
   WORKS	W ER K S
   WORKSHOP	W ER K SH AA P
   WORLD	W ER L D
   WORLDWIDE	W ER L D W AY D
   WORRIED	W ER IY D
   WORRY	W ER IY
   WORTH	W ER TH
   WOULD	W UH D
   WOUND	W AW N D
   WOW	W AW
   WRAP	R AE P
   WRIST	R IH S T
   WRITE	R AY T
   WRITER	R AY T ER
   WRITING	R AY T IH NG
   WRITTEN	R IH T AH N
   WRONG	R AO NG
   YARD	Y AA R D
   YEAH	Y IY
   YEAR	Y IH ER
   YELL	Y EH L
   YELLOW	Y EH L OW
   YES	Y EH S
   YESTERDAY	Y EH S T ER D IY
   YET	Y EH T
   YIELD	Y IY L D
   YOU	Y UW
   YOUNG	Y AH NG
   YOUNGSTER	Y AH NG S T ER
   YOUR	Y UH R
   YOURS	Y UH R Z
   YOURSELF	Y ER S EH L F
   YOUTH	Y UW TH
   ZONE	Z OW N
